,data,stato,codice_regione,lat,long,ricoverati_con_sintomi,terapia_intensiva,totale_ospedalizzati,isolamento_domiciliare,totale_attualmente_positivi,nuovi_attualmente_positivi,dimessi_guariti,deceduti,totale_casi,tamponi,note_it,note_en,regione,abitanti
0,2020-02-24T18:00:00,ITA,13,42.35122196,13.39843823,0,0,0,0,0,0,0,0,0,5,,,Abruzzo,1322247
1,2020-02-25T18:00:00,ITA,13,42.35122196,13.39843823,0,0,0,0,0,0,0,0,0,5,,,Abruzzo,1322247
2,2020-02-26T18:00:00,ITA,13,42.35122196,13.39843823,0,0,0,0,0,0,0,0,0,13,,,Abruzzo,1322247
3,2020-02-27T18:00:00,ITA,13,42.35122196,13.39843823,1,0,1,0,1,1,0,0,1,33,,,Abruzzo,1322247
4,2020-02-28T18:00:00,ITA,13,42.35122196,13.39843823,1,0,1,0,1,0,0,0,1,33,,,Abruzzo,1322247
5,2020-02-29T17:00:00,ITA,13,42.35122196,13.39843823,2,0,2,0,2,1,0,0,2,43,,,Abruzzo,1322247
6,2020-03-01T17:00:00,ITA,13,42.35122196,13.39843823,3,0,3,2,5,3,0,0,5,52,,,Abruzzo,1322247
7,2020-03-02T18:00:00,ITA,13,42.35122196,13.39843823,3,0,3,2,5,0,0,0,5,52,,,Abruzzo,1322247
8,2020-03-03T18:00:00,ITA,13,42.35122196,13.39843823,5,0,5,1,6,1,0,0,6,52,,,Abruzzo,1322247
9,2020-03-04T17:00:00,ITA,13,42.35122196,13.39843823,7,0,7,0,7,1,0,0,7,85,,,Abruzzo,1322247
10,2020-03-05T17:00:00,ITA,13,42.35122196,13.39843823,8,0,8,0,8,1,0,0,8,96,,,Abruzzo,1322247
11,2020-03-06T17:00:00,ITA,13,42.35122196,13.39843823,9,0,9,0,9,1,0,0,9,96,,,Abruzzo,1322247
12,2020-03-07T18:00:00,ITA,13,42.35122196,13.39843823,11,0,11,0,11,2,0,0,11,123,,,Abruzzo,1322247
13,2020-03-08T18:00:00,ITA,13,42.35122196,13.39843823,14,0,14,3,17,6,0,0,17,163,,,Abruzzo,1322247
14,2020-03-09T18:00:00,ITA,13,42.35122196,13.39843823,25,0,25,5,30,13,0,0,30,237,,,Abruzzo,1322247
15,2020-03-10T18:00:00,ITA,13,42.35122196,13.39843823,17,9,26,11,37,7,0,1,38,310,,,Abruzzo,1322247
16,2020-03-11T17:00:00,ITA,13,42.35122196,13.39843823,17,9,26,11,37,0,0,1,38,310,nd-IT-0001,nd-EN-0001,Abruzzo,1322247
17,2020-03-12T17:00:00,ITA,13,42.35122196,13.39843823,47,12,59,19,78,41,4,2,84,867,,,Abruzzo,1322247
18,2020-03-13T17:00:00,ITA,13,42.35122196,13.39843823,42,14,56,27,83,5,4,2,89,958,,,Abruzzo,1322247
19,2020-03-14T17:00:00,ITA,13,42.35122196,13.39843823,51,14,65,41,106,23,4,2,112,1232,,,Abruzzo,1322247
20,2020-03-15T17:00:00,ITA,13,42.35122196,13.39843823,72,28,100,28,128,22,6,3,137,1419,,,Abruzzo,1322247
21,2020-03-16T17:00:00,ITA,13,42.35122196,13.39843823,71,37,108,57,165,37,7,4,176,1533,,,Abruzzo,1322247
22,2020-03-17T17:00:00,ITA,13,42.35122196,13.39843823,94,32,126,90,216,51,7,6,229,1688,,,Abruzzo,1322247
23,2020-03-18T17:00:00,ITA,13,42.35122196,13.39843823,99,41,140,109,249,33,7,7,263,2054,,,Abruzzo,1322247
24,2020-03-19T17:00:00,ITA,13,42.35122196,13.39843823,181,47,228,138,366,117,8,11,385,2409,,,Abruzzo,1322247
25,2020-03-20T17:00:00,ITA,13,42.35122196,13.39843823,190,48,238,184,422,56,10,17,449,2695,,,Abruzzo,1322247
26,2020-03-21T17:00:00,ITA,13,42.35122196,13.39843823,185,44,229,265,494,72,13,22,529,3035,,,Abruzzo,1322247
27,2020-03-22T17:00:00,ITA,13,42.35122196,13.39843823,218,49,267,272,539,45,15,33,587,3375,,,Abruzzo,1322247
28,2020-03-23T17:00:00,ITA,13,42.35122196,13.39843823,228,52,280,325,605,66,20,38,663,3674,,,Abruzzo,1322247
29,2020-03-24T17:00:00,ITA,13,42.35122196,13.39843823,234,57,291,331,622,17,21,46,689,4294,,,Abruzzo,1322247
30,2020-03-25T17:00:00,ITA,13,42.35122196,13.39843823,248,59,307,431,738,116,23,52,813,4982,,,Abruzzo,1322247
31,2020-03-26T17:00:00,ITA,13,42.35122196,13.39843823,280,64,344,516,860,122,23,63,946,5488,,,Abruzzo,1322247
32,2020-03-27T17:00:00,ITA,13,42.35122196,13.39843823,289,71,360,565,925,65,24,68,1017,6109,,,Abruzzo,1322247
33,2020-03-28T17:00:00,ITA,13,42.35122196,13.39843823,311,70,381,646,1027,102,30,76,1133,7003,,,Abruzzo,1322247
34,2020-02-24T18:00:00,ITA,17,40.63947052,15.80514834,0,0,0,0,0,0,0,0,0,0,,,Basilicata,570365
35,2020-02-25T18:00:00,ITA,17,40.63947052,15.80514834,0,0,0,0,0,0,0,0,0,0,,,Basilicata,570365
36,2020-02-26T18:00:00,ITA,17,40.63947052,15.80514834,0,0,0,0,0,0,0,0,0,0,,,Basilicata,570365
37,2020-02-27T18:00:00,ITA,17,40.63947052,15.80514834,0,0,0,0,0,0,0,0,0,0,,,Basilicata,570365
38,2020-02-28T18:00:00,ITA,17,40.63947052,15.80514834,0,0,0,0,0,0,0,0,0,0,,,Basilicata,570365
39,2020-02-29T17:00:00,ITA,17,40.63947052,15.80514834,0,0,0,0,0,0,0,0,0,32,,,Basilicata,570365
40,2020-03-01T17:00:00,ITA,17,40.63947052,15.80514834,0,0,0,0,0,0,0,0,0,39,,,Basilicata,570365
41,2020-03-02T18:00:00,ITA,17,40.63947052,15.80514834,0,0,0,0,0,0,0,0,0,39,,,Basilicata,570365
42,2020-03-03T18:00:00,ITA,17,40.63947052,15.80514834,0,0,0,1,1,1,0,0,1,42,,,Basilicata,570365
43,2020-03-04T17:00:00,ITA,17,40.63947052,15.80514834,0,0,0,1,1,0,0,0,1,48,,,Basilicata,570365
44,2020-03-05T17:00:00,ITA,17,40.63947052,15.80514834,0,0,0,1,1,0,0,0,1,54,,,Basilicata,570365
45,2020-03-06T17:00:00,ITA,17,40.63947052,15.80514834,1,0,1,2,3,2,0,0,3,63,,,Basilicata,570365
46,2020-03-07T18:00:00,ITA,17,40.63947052,15.80514834,1,0,1,2,3,0,0,0,3,75,,,Basilicata,570365
47,2020-03-08T18:00:00,ITA,17,40.63947052,15.80514834,2,0,2,2,4,1,0,0,4,123,,,Basilicata,570365
48,2020-03-09T18:00:00,ITA,17,40.63947052,15.80514834,2,0,2,3,5,1,0,0,5,135,,,Basilicata,570365
49,2020-03-10T18:00:00,ITA,17,40.63947052,15.80514834,2,0,2,5,7,2,0,0,7,148,,,Basilicata,570365
50,2020-03-11T17:00:00,ITA,17,40.63947052,15.80514834,1,1,2,6,8,1,0,0,8,155,,,Basilicata,570365
51,2020-03-12T17:00:00,ITA,17,40.63947052,15.80514834,1,1,2,6,8,0,0,0,8,155,,,Basilicata,570365
52,2020-03-13T17:00:00,ITA,17,40.63947052,15.80514834,1,1,2,8,10,2,0,0,10,155,,,Basilicata,570365
53,2020-03-14T17:00:00,ITA,17,40.63947052,15.80514834,0,2,2,8,10,0,0,0,10,155,,,Basilicata,570365
54,2020-03-15T17:00:00,ITA,17,40.63947052,15.80514834,0,2,2,9,11,1,0,0,11,208,,,Basilicata,570365
55,2020-03-16T17:00:00,ITA,17,40.63947052,15.80514834,1,2,3,9,12,1,0,0,12,230,,,Basilicata,570365
56,2020-03-17T17:00:00,ITA,17,40.63947052,15.80514834,5,2,7,13,20,8,0,0,20,262,,,Basilicata,570365
57,2020-03-18T17:00:00,ITA,17,40.63947052,15.80514834,9,2,11,16,27,7,0,0,27,262,,,Basilicata,570365
58,2020-03-19T17:00:00,ITA,17,40.63947052,15.80514834,8,5,13,24,37,10,0,0,37,353,,,Basilicata,570365
59,2020-03-20T17:00:00,ITA,17,40.63947052,15.80514834,8,5,13,39,52,15,0,0,52,443,,,Basilicata,570365
60,2020-03-21T17:00:00,ITA,17,40.63947052,15.80514834,12,7,19,47,66,14,0,0,66,522,,,Basilicata,570365
61,2020-03-22T17:00:00,ITA,17,40.63947052,15.80514834,13,10,23,58,81,15,0,0,81,643,,,Basilicata,570365
62,2020-03-23T17:00:00,ITA,17,40.63947052,15.80514834,15,12,27,62,89,8,0,1,90,696,,,Basilicata,570365
63,2020-03-24T17:00:00,ITA,17,40.63947052,15.80514834,14,12,26,65,91,2,0,1,92,744,,,Basilicata,570365
64,2020-03-25T17:00:00,ITA,17,40.63947052,15.80514834,20,14,34,78,112,21,0,1,113,857,,,Basilicata,570365
65,2020-03-26T17:00:00,ITA,17,40.63947052,15.80514834,22,16,38,95,133,21,0,1,134,1046,,,Basilicata,570365
66,2020-03-27T17:00:00,ITA,17,40.63947052,15.80514834,22,15,37,110,147,14,1,3,151,1254,,,Basilicata,570365
67,2020-03-28T17:00:00,ITA,17,40.63947052,15.80514834,26,19,45,133,178,31,1,3,182,1421,,,Basilicata,570365
68,2020-02-24T18:00:00,ITA,18,38.90597598,16.59440194,0,0,0,0,0,0,0,0,0,1,,,Calabria,1965128
69,2020-02-25T18:00:00,ITA,18,38.90597598,16.59440194,0,0,0,0,0,0,0,0,0,2,,,Calabria,1965128
70,2020-02-26T18:00:00,ITA,18,38.90597598,16.59440194,0,0,0,0,0,0,0,0,0,3,,,Calabria,1965128
71,2020-02-27T18:00:00,ITA,18,38.90597598,16.59440194,0,0,0,0,0,0,0,0,0,14,,,Calabria,1965128
72,2020-02-28T18:00:00,ITA,18,38.90597598,16.59440194,0,0,0,1,1,1,0,0,1,21,,,Calabria,1965128
73,2020-02-29T17:00:00,ITA,18,38.90597598,16.59440194,0,0,0,1,1,0,0,0,1,27,,,Calabria,1965128
74,2020-03-01T17:00:00,ITA,18,38.90597598,16.59440194,0,0,0,1,1,0,0,0,1,35,,,Calabria,1965128
75,2020-03-02T18:00:00,ITA,18,38.90597598,16.59440194,0,0,0,1,1,0,0,0,1,39,,,Calabria,1965128
76,2020-03-03T18:00:00,ITA,18,38.90597598,16.59440194,0,0,0,1,1,0,0,0,1,39,,,Calabria,1965128
77,2020-03-04T17:00:00,ITA,18,38.90597598,16.59440194,0,0,0,1,1,0,0,0,1,46,,,Calabria,1965128
78,2020-03-05T17:00:00,ITA,18,38.90597598,16.59440194,1,0,1,1,2,1,0,0,2,53,,,Calabria,1965128
79,2020-03-06T17:00:00,ITA,18,38.90597598,16.59440194,2,0,2,2,4,2,0,0,4,99,,,Calabria,1965128
80,2020-03-07T18:00:00,ITA,18,38.90597598,16.59440194,2,0,2,2,4,0,0,0,4,113,,,Calabria,1965128
81,2020-03-08T18:00:00,ITA,18,38.90597598,16.59440194,5,0,5,4,9,5,0,0,9,113,,,Calabria,1965128
82,2020-03-09T18:00:00,ITA,18,38.90597598,16.59440194,8,0,8,1,9,0,2,0,11,173,,,Calabria,1965128
83,2020-03-10T18:00:00,ITA,18,38.90597598,16.59440194,8,2,10,1,11,2,2,0,13,360,,,Calabria,1965128
84,2020-03-11T17:00:00,ITA,18,38.90597598,16.59440194,10,2,12,5,17,6,2,0,19,405,,,Calabria,1965128
85,2020-03-12T17:00:00,ITA,18,38.90597598,16.59440194,14,2,16,16,32,15,1,0,33,483,,,Calabria,1965128
86,2020-03-13T17:00:00,ITA,18,38.90597598,16.59440194,18,3,21,16,37,5,1,0,38,504,,,Calabria,1965128
87,2020-03-14T17:00:00,ITA,18,38.90597598,16.59440194,22,4,26,33,59,22,1,0,60,711,,,Calabria,1965128
88,2020-03-15T17:00:00,ITA,18,38.90597598,16.59440194,32,6,38,28,66,7,1,1,68,884,,,Calabria,1965128
89,2020-03-16T17:00:00,ITA,18,38.90597598,16.59440194,36,7,43,44,87,21,1,1,89,1030,,,Calabria,1965128
90,2020-03-17T17:00:00,ITA,18,38.90597598,16.59440194,45,10,55,57,112,25,1,1,114,1293,,,Calabria,1965128
91,2020-03-18T17:00:00,ITA,18,38.90597598,16.59440194,45,11,56,70,126,14,2,1,129,1668,,,Calabria,1965128
92,2020-03-19T17:00:00,ITA,18,38.90597598,16.59440194,60,13,73,91,164,38,2,3,169,2342,,,Calabria,1965128
93,2020-03-20T17:00:00,ITA,18,38.90597598,16.59440194,71,16,87,114,201,37,2,4,207,2690,,,Calabria,1965128
94,2020-03-21T17:00:00,ITA,18,38.90597598,16.59440194,73,16,89,136,225,24,5,5,235,3050,,,Calabria,1965128
95,2020-03-22T17:00:00,ITA,18,38.90597598,16.59440194,77,17,94,166,260,35,5,8,273,3666,,,Calabria,1965128
96,2020-03-23T17:00:00,ITA,18,38.90597598,16.59440194,82,20,102,178,280,20,5,7,292,4073,,,Calabria,1965128
97,2020-03-24T17:00:00,ITA,18,38.90597598,16.59440194,88,21,109,195,304,24,5,10,319,4486,,,Calabria,1965128
98,2020-03-25T17:00:00,ITA,18,38.90597598,16.59440194,93,23,116,217,333,29,7,11,351,5058,,,Calabria,1965128
99,2020-03-26T17:00:00,ITA,18,38.90597598,16.59440194,101,23,124,248,372,39,7,14,393,5933,,,Calabria,1965128
100,2020-03-27T17:00:00,ITA,18,38.90597598,16.59440194,103,22,125,344,469,97,7,18,494,6901,,,Calabria,1965128
101,2020-03-28T17:00:00,ITA,18,38.90597598,16.59440194,107,22,129,394,523,54,11,21,555,7760,,,Calabria,1965128
102,2020-02-24T18:00:00,ITA,15,40.83956555,14.25084984,0,0,0,0,0,0,0,0,0,10,,,Campania,5839084
103,2020-02-25T18:00:00,ITA,15,40.83956555,14.25084984,0,0,0,0,0,0,0,0,0,10,,,Campania,5839084
104,2020-02-26T18:00:00,ITA,15,40.83956555,14.25084984,0,0,0,0,0,0,0,0,0,10,,,Campania,5839084
105,2020-02-27T18:00:00,ITA,15,40.83956555,14.25084984,2,0,2,1,3,3,0,0,3,10,,,Campania,5839084
106,2020-02-28T18:00:00,ITA,15,40.83956555,14.25084984,2,0,2,2,4,1,0,0,4,213,,,Campania,5839084
107,2020-02-29T17:00:00,ITA,15,40.83956555,14.25084984,3,0,3,10,13,9,0,0,13,373,,,Campania,5839084
108,2020-03-01T17:00:00,ITA,15,40.83956555,14.25084984,4,0,4,13,17,4,0,0,17,373,,,Campania,5839084
109,2020-03-02T18:00:00,ITA,15,40.83956555,14.25084984,4,0,4,13,17,0,0,0,17,373,,,Campania,5839084
110,2020-03-03T18:00:00,ITA,15,40.83956555,14.25084984,11,0,11,19,30,13,0,0,30,405,,,Campania,5839084
111,2020-03-04T17:00:00,ITA,15,40.83956555,14.25084984,11,0,11,20,31,1,0,0,31,429,,,Campania,5839084
112,2020-03-05T17:00:00,ITA,15,40.83956555,14.25084984,12,0,12,33,45,14,0,0,45,471,,,Campania,5839084
113,2020-03-06T17:00:00,ITA,15,40.83956555,14.25084984,12,0,12,45,57,12,0,0,57,471,,,Campania,5839084
114,2020-03-07T18:00:00,ITA,15,40.83956555,14.25084984,16,0,16,45,61,4,0,0,61,612,,,Campania,5839084
115,2020-03-08T18:00:00,ITA,15,40.83956555,14.25084984,30,7,37,63,100,39,1,0,101,980,,,Campania,5839084
116,2020-03-09T18:00:00,ITA,15,40.83956555,14.25084984,42,8,50,69,119,19,1,0,120,980,,,Campania,5839084
117,2020-03-10T18:00:00,ITA,15,40.83956555,14.25084984,33,8,41,85,126,7,1,0,127,1141,,,Campania,5839084
118,2020-03-11T17:00:00,ITA,15,40.83956555,14.25084984,56,11,67,82,149,23,4,1,154,1375,,,Campania,5839084
119,2020-03-12T17:00:00,ITA,15,40.83956555,14.25084984,56,11,67,107,174,25,4,1,179,1551,,,Campania,5839084
120,2020-03-13T17:00:00,ITA,15,40.83956555,14.25084984,60,19,79,134,213,39,5,2,220,1671,,,Campania,5839084
121,2020-03-14T17:00:00,ITA,15,40.83956555,14.25084984,72,17,89,154,243,30,23,6,272,1936,,,Campania,5839084
122,2020-03-15T17:00:00,ITA,15,40.83956555,14.25084984,73,22,95,201,296,53,28,9,333,2213,,,Campania,5839084
123,2020-03-16T17:00:00,ITA,15,40.83956555,14.25084984,103,22,125,238,363,67,28,9,400,2517,,,Campania,5839084
124,2020-03-17T17:00:00,ITA,15,40.83956555,14.25084984,127,24,151,272,423,60,28,9,460,2685,,,Campania,5839084
125,2020-03-18T17:00:00,ITA,15,40.83956555,14.25084984,127,24,151,272,423,0,28,9,460,2685,nd-IT-0013,nd-EN-0013,Campania,5839084
126,2020-03-19T17:00:00,ITA,15,40.83956555,14.25084984,213,36,249,356,605,182,30,17,652,3544,,,Campania,5839084
127,2020-03-20T17:00:00,ITA,15,40.83956555,14.25084984,130,41,171,531,702,97,30,17,749,3845,,,Campania,5839084
128,2020-03-21T17:00:00,ITA,15,40.83956555,14.25084984,233,87,320,473,793,91,29,22,844,4448,,,Campania,5839084
129,2020-03-22T17:00:00,ITA,15,40.83956555,14.25084984,243,99,342,524,866,73,41,29,936,4943,,,Campania,5839084
130,2020-03-23T17:00:00,ITA,15,40.83956555,14.25084984,266,110,376,553,929,63,48,49,1026,5813,,,Campania,5839084
131,2020-03-24T17:00:00,ITA,15,40.83956555,14.25084984,345,181,526,466,992,63,53,56,1101,6297,,,Campania,5839084
132,2020-03-25T17:00:00,ITA,15,40.83956555,14.25084984,318,123,441,631,1072,80,53,74,1199,6972,,,Campania,5839084
133,2020-03-26T17:00:00,ITA,15,40.83956555,14.25084984,448,114,562,607,1169,97,58,83,1310,8346,,,Campania,5839084
134,2020-03-27T17:00:00,ITA,15,40.83956555,14.25084984,456,113,569,723,1292,123,64,98,1454,9613,,,Campania,5839084
135,2020-03-28T17:00:00,ITA,15,40.83956555,14.25084984,463,132,595,812,1407,115,76,109,1592,10616,,,Campania,5839084
136,2020-02-24T18:00:00,ITA,8,44.49436681,11.341720800000001,10,2,12,6,18,18,0,0,18,148,,,Emilia Romagna,4448841
137,2020-02-25T18:00:00,ITA,8,44.49436681,11.341720800000001,15,2,17,9,26,8,0,0,26,391,,,Emilia Romagna,4448841
138,2020-02-26T18:00:00,ITA,8,44.49436681,11.341720800000001,20,3,23,23,46,20,0,1,47,577,,,Emilia Romagna,4448841
139,2020-02-27T18:00:00,ITA,8,44.49436681,11.341720800000001,36,6,42,54,96,50,0,1,97,1033,,,Emilia Romagna,4448841
140,2020-02-28T18:00:00,ITA,8,44.49436681,11.341720800000001,56,6,62,81,143,47,0,2,145,1277,,,Emilia Romagna,4448841
141,2020-02-29T17:00:00,ITA,8,44.49436681,11.341720800000001,86,11,97,116,213,70,0,4,217,1550,,,Emilia Romagna,4448841
142,2020-03-01T17:00:00,ITA,8,44.49436681,11.341720800000001,127,13,140,137,277,64,0,8,285,1795,,,Emilia Romagna,4448841
143,2020-03-02T18:00:00,ITA,8,44.49436681,11.341720800000001,148,16,164,160,324,47,0,11,335,1973,,,Emilia Romagna,4448841
144,2020-03-03T18:00:00,ITA,8,44.49436681,11.341720800000001,187,24,211,187,398,74,4,18,420,2012,,,Emilia Romagna,4448841
145,2020-03-04T17:00:00,ITA,8,44.49436681,11.341720800000001,256,26,282,234,516,118,6,22,544,2500,,,Emilia Romagna,4448841
146,2020-03-05T17:00:00,ITA,8,44.49436681,11.341720800000001,327,32,359,299,658,142,10,30,698,2884,,,Emilia Romagna,4448841
147,2020-03-06T17:00:00,ITA,8,44.49436681,11.341720800000001,397,53,450,366,816,158,17,37,870,3136,,,Emilia Romagna,4448841
148,2020-03-07T18:00:00,ITA,8,44.49436681,11.341720800000001,464,64,528,409,937,121,25,48,1010,3604,,,Emilia Romagna,4448841
149,2020-03-08T18:00:00,ITA,8,44.49436681,11.341720800000001,542,75,617,480,1097,160,27,56,1180,4344,,,Emilia Romagna,4448841
150,2020-03-09T18:00:00,ITA,8,44.49436681,11.341720800000001,576,90,666,620,1286,189,30,70,1386,4906,,,Emilia Romagna,4448841
151,2020-03-10T18:00:00,ITA,8,44.49436681,11.341720800000001,669,98,767,650,1417,131,31,85,1533,5494,,,Emilia Romagna,4448841
152,2020-03-11T17:00:00,ITA,8,44.49436681,11.341720800000001,745,104,849,739,1588,171,38,113,1739,6640,,,Emilia Romagna,4448841
153,2020-03-12T17:00:00,ITA,8,44.49436681,11.341720800000001,814,112,926,832,1758,170,43,146,1947,7600,,,Emilia Romagna,4448841
154,2020-03-13T17:00:00,ITA,8,44.49436681,11.341720800000001,942,128,1070,941,2011,253,51,201,2263,8787,,,Emilia Romagna,4448841
155,2020-03-14T17:00:00,ITA,8,44.49436681,11.341720800000001,1076,152,1228,1121,2349,338,54,241,2644,10043,,,Emilia Romagna,4448841
156,2020-03-15T17:00:00,ITA,8,44.49436681,11.341720800000001,1215,169,1384,1357,2741,392,68,284,3093,12054,,,Emilia Romagna,4448841
157,2020-03-16T17:00:00,ITA,8,44.49436681,11.341720800000001,1362,197,1559,1529,3088,347,88,346,3522,13096,,,Emilia Romagna,4448841
158,2020-03-17T17:00:00,ITA,8,44.49436681,11.341720800000001,1566,223,1789,1615,3404,316,134,393,3931,14510,nd-IT-0008,nd-EN-0008,Emilia Romagna,4448841
159,2020-03-18T17:00:00,ITA,8,44.49436681,11.341720800000001,1784,247,2031,1884,3915,511,152,458,4525,15461,nd-IT-0011,nd-EN-0011,Emilia Romagna,4448841
160,2020-03-19T17:00:00,ITA,8,44.49436681,11.341720800000001,1900,260,2160,2346,4506,591,177,531,5214,18344,,,Emilia Romagna,4448841
161,2020-03-20T17:00:00,ITA,8,44.49436681,11.341720800000001,2083,267,2350,2739,5089,583,239,640,5968,20753,,,Emilia Romagna,4448841
162,2020-03-21T17:00:00,ITA,8,44.49436681,11.341720800000001,2267,265,2532,3129,5661,572,329,715,6705,24620,,,Emilia Romagna,4448841
163,2020-03-22T17:00:00,ITA,8,44.49436681,11.341720800000001,2429,269,2698,3692,6390,729,349,816,7555,28022,,,Emilia Romagna,4448841
164,2020-03-23T17:00:00,ITA,8,44.49436681,11.341720800000001,2846,276,3122,4098,7220,830,423,892,8535,31200,,,Emilia Romagna,4448841
165,2020-03-24T17:00:00,ITA,8,44.49436681,11.341720800000001,2974,291,3265,4446,7711,491,558,985,9254,33527,,,Emilia Romagna,4448841
166,2020-03-25T17:00:00,ITA,8,44.49436681,11.341720800000001,3180,294,3474,4782,8256,545,721,1077,10054,38045,,,Emilia Romagna,4448841
167,2020-03-26T17:00:00,ITA,8,44.49436681,11.341720800000001,3354,301,3655,5195,8850,594,792,1174,10816,42395,,,Emilia Romagna,4448841
168,2020-03-27T17:00:00,ITA,8,44.49436681,11.341720800000001,3461,308,3769,5592,9361,511,960,1267,11588,47798,,,Emilia Romagna,4448841
169,2020-03-28T17:00:00,ITA,8,44.49436681,11.341720800000001,3695,316,4011,5953,9964,603,1075,1344,12383,52991,,,Emilia Romagna,4448841
170,2020-02-24T18:00:00,ITA,6,45.6494354,13.76813649,0,0,0,0,0,0,0,0,0,58,,,Friuli Venezia Giulia,1217872
171,2020-02-25T18:00:00,ITA,6,45.6494354,13.76813649,0,0,0,0,0,0,0,0,0,89,,,Friuli Venezia Giulia,1217872
172,2020-02-26T18:00:00,ITA,6,45.6494354,13.76813649,0,0,0,0,0,0,0,0,0,114,,,Friuli Venezia Giulia,1217872
173,2020-02-27T18:00:00,ITA,6,45.6494354,13.76813649,0,0,0,0,0,0,0,0,0,141,,,Friuli Venezia Giulia,1217872
174,2020-02-28T18:00:00,ITA,6,45.6494354,13.76813649,0,0,0,0,0,0,0,0,0,169,,,Friuli Venezia Giulia,1217872
175,2020-02-29T17:00:00,ITA,6,45.6494354,13.76813649,0,0,0,0,0,0,0,0,0,189,,,Friuli Venezia Giulia,1217872
176,2020-03-01T17:00:00,ITA,6,45.6494354,13.76813649,0,0,0,6,6,6,0,0,6,243,,,Friuli Venezia Giulia,1217872
177,2020-03-02T18:00:00,ITA,6,45.6494354,13.76813649,0,0,0,9,9,3,0,0,9,269,,,Friuli Venezia Giulia,1217872
178,2020-03-03T18:00:00,ITA,6,45.6494354,13.76813649,1,0,1,12,13,4,0,0,13,354,,,Friuli Venezia Giulia,1217872
179,2020-03-04T17:00:00,ITA,6,45.6494354,13.76813649,3,0,3,15,18,5,0,0,18,376,,,Friuli Venezia Giulia,1217872
180,2020-03-05T17:00:00,ITA,6,45.6494354,13.76813649,4,0,4,17,21,3,0,0,21,397,,,Friuli Venezia Giulia,1217872
181,2020-03-06T17:00:00,ITA,6,45.6494354,13.76813649,4,0,4,24,28,7,3,0,31,577,,,Friuli Venezia Giulia,1217872
182,2020-03-07T18:00:00,ITA,6,45.6494354,13.76813649,7,1,8,31,39,11,3,0,42,577,,,Friuli Venezia Giulia,1217872
183,2020-03-08T18:00:00,ITA,6,45.6494354,13.76813649,7,1,8,45,53,14,3,1,57,997,,,Friuli Venezia Giulia,1217872
184,2020-03-09T18:00:00,ITA,6,45.6494354,13.76813649,18,1,19,70,89,36,3,1,93,1344,,,Friuli Venezia Giulia,1217872
185,2020-03-10T18:00:00,ITA,6,45.6494354,13.76813649,27,6,33,77,110,21,3,3,116,1602,,,Friuli Venezia Giulia,1217872
186,2020-03-11T17:00:00,ITA,6,45.6494354,13.76813649,16,5,21,89,110,0,10,6,126,2073,,,Friuli Venezia Giulia,1217872
187,2020-03-12T17:00:00,ITA,6,45.6494354,13.76813649,23,10,33,115,148,38,11,8,167,2604,,,Friuli Venezia Giulia,1217872
188,2020-03-13T17:00:00,ITA,6,45.6494354,13.76813649,59,8,67,169,236,88,11,10,257,3149,,,Friuli Venezia Giulia,1217872
189,2020-03-14T17:00:00,ITA,6,45.6494354,13.76813649,67,11,78,193,271,35,17,13,301,3376,,,Friuli Venezia Giulia,1217872
190,2020-03-15T17:00:00,ITA,6,45.6494354,13.76813649,98,12,110,206,316,45,17,14,347,3407,,,Friuli Venezia Giulia,1217872
191,2020-03-16T17:00:00,ITA,6,45.6494354,13.76813649,96,19,115,231,346,30,18,22,386,4851,,,Friuli Venezia Giulia,1217872
192,2020-03-17T17:00:00,ITA,6,45.6494354,13.76813649,104,21,125,222,347,1,17,30,394,4958,,,Friuli Venezia Giulia,1217872
193,2020-03-18T17:00:00,ITA,6,45.6494354,13.76813649,128,27,155,261,416,69,15,31,462,4958,,,Friuli Venezia Giulia,1217872
194,2020-03-19T17:00:00,ITA,6,45.6494354,13.76813649,134,29,163,359,522,106,41,36,599,4052,,,Friuli Venezia Giulia,1217872
195,2020-03-20T17:00:00,ITA,6,45.6494354,13.76813649,143,32,175,380,555,33,63,38,656,4964,,,Friuli Venezia Giulia,1217872
196,2020-03-21T17:00:00,ITA,6,45.6494354,13.76813649,152,37,189,477,666,111,82,42,790,5955,,,Friuli Venezia Giulia,1217872
197,2020-03-22T17:00:00,ITA,6,45.6494354,13.76813649,163,47,210,528,738,72,89,47,874,6761,,,Friuli Venezia Giulia,1217872
198,2020-03-23T17:00:00,ITA,6,45.6494354,13.76813649,185,41,226,545,771,33,105,54,930,7424,,,Friuli Venezia Giulia,1217872
199,2020-03-24T17:00:00,ITA,6,45.6494354,13.76813649,195,49,244,604,848,77,80,64,992,8526,,,Friuli Venezia Giulia,1217872
200,2020-03-25T17:00:00,ITA,6,45.6494354,13.76813649,200,52,252,659,911,63,158,70,1139,9494,,,Friuli Venezia Giulia,1217872
201,2020-03-26T17:00:00,ITA,6,45.6494354,13.76813649,212,54,266,688,954,43,197,72,1223,10721,,,Friuli Venezia Giulia,1217872
202,2020-03-27T17:00:00,ITA,6,45.6494354,13.76813649,222,57,279,748,1027,73,214,76,1317,11841,,,Friuli Venezia Giulia,1217872
203,2020-03-28T17:00:00,ITA,6,45.6494354,13.76813649,223,59,282,838,1120,93,229,87,1436,12723,,,Friuli Venezia Giulia,1217872
204,2020-02-24T18:00:00,ITA,12,41.89277044,12.48366722,1,1,2,0,2,2,1,0,3,124,,,Lazio,5898124
205,2020-02-25T18:00:00,ITA,12,41.89277044,12.48366722,1,1,2,0,2,0,1,0,3,124,,,Lazio,5898124
206,2020-02-26T18:00:00,ITA,12,41.89277044,12.48366722,0,0,0,0,0,-2,3,0,3,124,,,Lazio,5898124
207,2020-02-27T18:00:00,ITA,12,41.89277044,12.48366722,0,0,0,0,0,0,3,0,3,552,,,Lazio,5898124
208,2020-02-28T18:00:00,ITA,12,41.89277044,12.48366722,0,0,0,0,0,0,3,0,3,611,,,Lazio,5898124
209,2020-02-29T17:00:00,ITA,12,41.89277044,12.48366722,3,0,3,0,3,3,3,0,6,679,,,Lazio,5898124
210,2020-03-01T17:00:00,ITA,12,41.89277044,12.48366722,3,0,3,0,3,0,3,0,6,724,,,Lazio,5898124
211,2020-03-02T18:00:00,ITA,12,41.89277044,12.48366722,3,0,3,1,4,1,3,0,7,773,,,Lazio,5898124
212,2020-03-03T18:00:00,ITA,12,41.89277044,12.48366722,10,0,10,1,11,7,3,0,14,877,,,Lazio,5898124
213,2020-03-04T17:00:00,ITA,12,41.89277044,12.48366722,15,3,18,9,27,16,3,0,30,995,,,Lazio,5898124
214,2020-03-05T17:00:00,ITA,12,41.89277044,12.48366722,20,7,27,14,41,14,3,0,44,1175,,,Lazio,5898124
215,2020-03-06T17:00:00,ITA,12,41.89277044,12.48366722,26,8,34,16,50,9,3,1,54,1373,,,Lazio,5898124
216,2020-03-07T18:00:00,ITA,12,41.89277044,12.48366722,43,8,51,21,72,22,3,1,76,1582,,,Lazio,5898124
217,2020-03-08T18:00:00,ITA,12,41.89277044,12.48366722,47,8,55,26,81,9,3,3,87,1929,,,Lazio,5898124
218,2020-03-09T18:00:00,ITA,12,41.89277044,12.48366722,55,8,63,31,94,13,3,5,102,1929,,,Lazio,5898124
219,2020-03-10T18:00:00,ITA,12,41.89277044,12.48366722,50,15,65,34,99,5,11,6,116,3591,,,Lazio,5898124
220,2020-03-11T17:00:00,ITA,12,41.89277044,12.48366722,67,18,85,40,125,26,19,6,150,3591,,,Lazio,5898124
221,2020-03-12T17:00:00,ITA,12,41.89277044,12.48366722,85,20,105,67,172,47,19,9,200,5592,,,Lazio,5898124
222,2020-03-13T17:00:00,ITA,12,41.89277044,12.48366722,122,24,146,96,242,70,24,11,277,6491,,,Lazio,5898124
223,2020-03-14T17:00:00,ITA,12,41.89277044,12.48366722,181,25,206,114,320,78,24,13,357,7335,,,Lazio,5898124
224,2020-03-15T17:00:00,ITA,12,41.89277044,12.48366722,223,31,254,142,396,76,24,16,436,8345,,,Lazio,5898124
225,2020-03-16T17:00:00,ITA,12,41.89277044,12.48366722,267,31,298,174,472,76,32,19,523,9330,,,Lazio,5898124
226,2020-03-17T17:00:00,ITA,12,41.89277044,12.48366722,314,44,358,192,550,78,34,23,607,9436,,,Lazio,5898124
227,2020-03-18T17:00:00,ITA,12,41.89277044,12.48366722,374,44,418,232,650,100,42,32,724,11145,,,Lazio,5898124
228,2020-03-19T17:00:00,ITA,12,41.89277044,12.48366722,426,45,471,270,741,91,44,38,823,11145,,,Lazio,5898124
229,2020-03-20T17:00:00,ITA,12,41.89277044,12.48366722,537,47,584,328,912,171,53,43,1008,13889,,,Lazio,5898124
230,2020-03-21T17:00:00,ITA,12,41.89277044,12.48366722,591,70,661,425,1086,174,54,50,1190,13889,,,Lazio,5898124
231,2020-03-22T17:00:00,ITA,12,41.89277044,12.48366722,671,79,750,522,1272,186,58,53,1383,17845,,,Lazio,5898124
232,2020-03-23T17:00:00,ITA,12,41.89277044,12.48366722,718,96,814,600,1414,142,63,63,1540,18371,,,Lazio,5898124
233,2020-03-24T17:00:00,ITA,12,41.89277044,12.48366722,747,94,841,704,1545,131,103,80,1728,18371,,,Lazio,5898124
234,2020-03-25T17:00:00,ITA,12,41.89277044,12.48366722,805,101,906,769,1675,130,131,95,1901,20669,,,Lazio,5898124
235,2020-03-26T17:00:00,ITA,12,41.89277044,12.48366722,878,113,991,844,1835,160,155,106,2096,22771,,,Lazio,5898124
236,2020-03-27T17:00:00,ITA,12,41.89277044,12.48366722,992,126,1118,895,2013,178,164,118,2295,24106,,,Lazio,5898124
237,2020-03-28T17:00:00,ITA,12,41.89277044,12.48366722,985,133,1118,1063,2181,168,200,124,2505,27179,,,Lazio,5898124
238,2020-02-24T18:00:00,ITA,7,44.41149315,8.9326992,0,0,0,0,0,0,0,0,0,1,,,Liguria,1565307
239,2020-02-25T18:00:00,ITA,7,44.41149315,8.9326992,1,0,1,0,1,1,0,0,1,39,,,Liguria,1565307
240,2020-02-26T18:00:00,ITA,7,44.41149315,8.9326992,6,0,6,5,11,10,0,0,11,66,,,Liguria,1565307
241,2020-02-27T18:00:00,ITA,7,44.41149315,8.9326992,9,0,9,10,19,8,0,0,19,78,,,Liguria,1565307
242,2020-02-28T18:00:00,ITA,7,44.41149315,8.9326992,9,0,9,10,19,0,0,0,19,112,,,Liguria,1565307
243,2020-02-29T17:00:00,ITA,7,44.41149315,8.9326992,4,1,5,33,38,19,4,0,42,121,,,Liguria,1565307
244,2020-03-01T17:00:00,ITA,7,44.41149315,8.9326992,12,1,13,8,21,-17,4,0,25,121,,,Liguria,1565307
245,2020-03-02T18:00:00,ITA,7,44.41149315,8.9326992,12,1,13,5,18,-3,4,0,22,121,,,Liguria,1565307
246,2020-03-03T18:00:00,ITA,7,44.41149315,8.9326992,12,2,14,5,19,1,4,1,24,121,,,Liguria,1565307
247,2020-03-04T17:00:00,ITA,7,44.41149315,8.9326992,10,3,13,8,21,2,4,1,26,133,,,Liguria,1565307
248,2020-03-05T17:00:00,ITA,7,44.41149315,8.9326992,11,3,14,7,21,0,4,3,28,146,,,Liguria,1565307
249,2020-03-06T17:00:00,ITA,7,44.41149315,8.9326992,12,5,17,7,24,3,5,3,32,229,,,Liguria,1565307
250,2020-03-07T18:00:00,ITA,7,44.41149315,8.9326992,26,6,32,10,42,18,5,4,51,331,,,Liguria,1565307
251,2020-03-08T18:00:00,ITA,7,44.41149315,8.9326992,39,11,50,17,67,25,5,6,78,401,,,Liguria,1565307
252,2020-03-09T18:00:00,ITA,7,44.41149315,8.9326992,60,17,77,20,97,30,5,7,109,611,,,Liguria,1565307
253,2020-03-10T18:00:00,ITA,7,44.41149315,8.9326992,57,29,86,42,128,31,5,8,141,694,,,Liguria,1565307
254,2020-03-11T17:00:00,ITA,7,44.41149315,8.9326992,74,34,108,73,181,53,5,8,194,1025,,,Liguria,1565307
255,2020-03-12T17:00:00,ITA,7,44.41149315,8.9326992,100,36,136,107,243,62,20,11,274,1174,,,Liguria,1565307
256,2020-03-13T17:00:00,ITA,7,44.41149315,8.9326992,128,44,172,132,304,61,24,17,345,1442,,,Liguria,1565307
257,2020-03-14T17:00:00,ITA,7,44.41149315,8.9326992,213,62,275,109,384,80,52,27,463,1750,,,Liguria,1565307
258,2020-03-15T17:00:00,ITA,7,44.41149315,8.9326992,253,66,319,174,493,109,33,33,559,1973,,,Liguria,1565307
259,2020-03-16T17:00:00,ITA,7,44.41149315,8.9326992,255,73,328,247,575,82,42,50,667,2189,,,Liguria,1565307
260,2020-03-17T17:00:00,ITA,7,44.41149315,8.9326992,299,85,384,277,661,86,57,60,778,2509,,,Liguria,1565307
261,2020-03-18T17:00:00,ITA,7,44.41149315,8.9326992,401,100,501,243,744,83,70,73,887,2912,,,Liguria,1565307
262,2020-03-19T17:00:00,ITA,7,44.41149315,8.9326992,491,112,603,280,883,139,85,91,1059,3348,,,Liguria,1565307
263,2020-03-20T17:00:00,ITA,7,44.41149315,8.9326992,573,121,694,307,1001,118,101,119,1221,3794,,,Liguria,1565307
264,2020-03-21T17:00:00,ITA,7,44.41149315,8.9326992,598,129,727,432,1159,158,125,152,1436,4304,,,Liguria,1565307
265,2020-03-22T17:00:00,ITA,7,44.41149315,8.9326992,736,132,868,483,1351,192,143,171,1665,4995,,,Liguria,1565307
266,2020-03-23T17:00:00,ITA,7,44.41149315,8.9326992,761,133,894,659,1553,202,159,212,1924,5538,,,Liguria,1565307
267,2020-03-24T17:00:00,ITA,7,44.41149315,8.9326992,803,147,950,742,1692,139,193,231,2116,5992,,,Liguria,1565307
268,2020-03-25T17:00:00,ITA,7,44.41149315,8.9326992,927,147,1074,752,1826,134,225,254,2305,6602,,,Liguria,1565307
269,2020-03-26T17:00:00,ITA,7,44.41149315,8.9326992,998,154,1152,875,2027,201,260,280,2567,7304,,,Liguria,1565307
270,2020-03-27T17:00:00,ITA,7,44.41149315,8.9326992,1023,157,1180,880,2060,33,305,331,2696,7804,,,Liguria,1565307
271,2020-03-28T17:00:00,ITA,7,44.41149315,8.9326992,1031,167,1198,888,2086,26,378,358,2822,8177,,,Liguria,1565307
272,2020-02-24T18:00:00,ITA,3,45.46679409,9.190347404,76,19,95,71,166,166,0,6,172,1463,,,Lombardia,10018806
273,2020-02-25T18:00:00,ITA,3,45.46679409,9.190347404,79,25,104,127,231,65,0,9,240,3700,,,Lombardia,10018806
274,2020-02-26T18:00:00,ITA,3,45.46679409,9.190347404,79,25,104,145,249,18,0,9,258,3208,,,Lombardia,10018806
275,2020-02-27T18:00:00,ITA,3,45.46679409,9.190347404,172,41,213,136,349,100,40,14,403,3320,,,Lombardia,10018806
276,2020-02-28T18:00:00,ITA,3,45.46679409,9.190347404,235,47,282,192,474,125,40,17,531,4835,,,Lombardia,10018806
277,2020-02-29T17:00:00,ITA,3,45.46679409,9.190347404,256,80,336,216,552,78,40,23,615,5723,,,Lombardia,10018806
278,2020-03-01T17:00:00,ITA,3,45.46679409,9.190347404,406,106,512,375,887,335,73,24,984,6879,,,Lombardia,10018806
279,2020-03-02T18:00:00,ITA,3,45.46679409,9.190347404,478,127,605,472,1077,190,139,38,1254,7925,,,Lombardia,10018806
280,2020-03-03T18:00:00,ITA,3,45.46679409,9.190347404,698,167,865,461,1326,249,139,55,1520,9577,,,Lombardia,10018806
281,2020-03-04T17:00:00,ITA,3,45.46679409,9.190347404,877,209,1086,411,1497,171,250,73,1820,12138,,,Lombardia,10018806
282,2020-03-05T17:00:00,ITA,3,45.46679409,9.190347404,1169,244,1413,364,1777,280,376,98,2251,12354,,,Lombardia,10018806
283,2020-03-06T17:00:00,ITA,3,45.46679409,9.190347404,1622,309,1931,77,2008,231,469,135,2612,13556,,,Lombardia,10018806
284,2020-03-07T18:00:00,ITA,3,45.46679409,9.190347404,1661,359,2020,722,2742,734,524,154,3420,15778,pd-IT-0002,pd-EN-0002,Lombardia,10018806
285,2020-03-08T18:00:00,ITA,3,45.46679409,9.190347404,2217,399,2616,756,3372,630,550,267,4189,18534,,,Lombardia,10018806
286,2020-03-09T18:00:00,ITA,3,45.46679409,9.190347404,2802,440,3242,1248,4490,1118,646,333,5469,20135,,,Lombardia,10018806
287,2020-03-10T18:00:00,ITA,3,45.46679409,9.190347404,3319,466,3785,642,4427,-63,896,468,5791,21479,pd-IT-0004,pd-EN-0004,Lombardia,10018806
288,2020-03-11T17:00:00,ITA,3,45.46679409,9.190347404,3852,560,4412,1351,5763,1336,900,617,7280,25629,,,Lombardia,10018806
289,2020-03-12T17:00:00,ITA,3,45.46679409,9.190347404,4247,605,4852,2044,6896,1133,1085,744,8725,29534,,,Lombardia,10018806
290,2020-03-13T17:00:00,ITA,3,45.46679409,9.190347404,4435,650,5085,2647,7732,836,1198,890,9820,32700,,,Lombardia,10018806
291,2020-03-14T17:00:00,ITA,3,45.46679409,9.190347404,4898,732,5630,3429,9059,1327,1660,966,11685,37138,,,Lombardia,10018806
292,2020-03-15T17:00:00,ITA,3,45.46679409,9.190347404,5500,767,6267,3776,10043,984,2011,1218,13272,40369,,,Lombardia,10018806
293,2020-03-16T17:00:00,ITA,3,45.46679409,9.190347404,6171,823,6994,3867,10861,818,2368,1420,14649,43565,,,Lombardia,10018806
294,2020-03-17T17:00:00,ITA,3,45.46679409,9.190347404,6953,879,7832,4263,12095,1234,2485,1640,16220,46449,,,Lombardia,10018806
295,2020-03-18T17:00:00,ITA,3,45.46679409,9.190347404,7285,924,8209,4057,12266,171,3488,1959,17713,48983,,,Lombardia,10018806
296,2020-03-19T17:00:00,ITA,3,45.46679409,9.190347404,7387,1006,8393,5545,13938,1672,3778,2168,19884,52244,,,Lombardia,10018806
297,2020-03-20T17:00:00,ITA,3,45.46679409,9.190347404,7735,1050,8785,6635,15420,1482,4295,2549,22264,57174,,,Lombardia,10018806
298,2020-03-21T17:00:00,ITA,3,45.46679409,9.190347404,8258,1093,9351,8019,17370,1950,5050,3095,25515,66730,,,Lombardia,10018806
299,2020-03-22T17:00:00,ITA,3,45.46679409,9.190347404,9439,1142,10581,7304,17885,515,5865,3456,27206,70598,,,Lombardia,10018806
300,2020-03-23T17:00:00,ITA,3,45.46679409,9.190347404,9266,1183,10449,8461,18910,1025,6075,3776,28761,73242,,,Lombardia,10018806
301,2020-03-24T17:00:00,ITA,3,45.46679409,9.190347404,9711,1194,10905,8963,19868,958,6657,4178,30703,76695,,,Lombardia,10018806
302,2020-03-25T17:00:00,ITA,3,45.46679409,9.190347404,10026,1236,11262,9329,20591,723,7281,4474,32346,81666,,,Lombardia,10018806
303,2020-03-26T17:00:00,ITA,3,45.46679409,9.190347404,10681,1263,11944,10245,22189,1598,7839,4861,34889,87713,,,Lombardia,10018806
304,2020-03-27T17:00:00,ITA,3,45.46679409,9.190347404,11137,1292,12429,11466,23895,1706,8001,5402,37298,95860,,,Lombardia,10018806
305,2020-03-28T17:00:00,ITA,3,45.46679409,9.190347404,11152,1319,12471,12038,24509,614,8962,5944,39415,102503,,,Lombardia,10018806
306,2020-02-24T18:00:00,ITA,11,43.61675973,13.5188753,0,0,0,0,0,0,0,0,0,16,,,Marche,1538055
307,2020-02-25T18:00:00,ITA,11,43.61675973,13.5188753,0,0,0,0,0,0,0,0,0,21,,,Marche,1538055
308,2020-02-26T18:00:00,ITA,11,43.61675973,13.5188753,1,0,1,0,1,1,0,0,1,28,,,Marche,1538055
309,2020-02-27T18:00:00,ITA,11,43.61675973,13.5188753,2,1,3,0,3,2,0,0,3,46,,,Marche,1538055
310,2020-02-28T18:00:00,ITA,11,43.61675973,13.5188753,3,2,5,1,6,3,0,0,6,47,,,Marche,1538055
311,2020-02-29T17:00:00,ITA,11,43.61675973,13.5188753,6,2,8,3,11,5,0,0,11,68,,,Marche,1538055
312,2020-03-01T17:00:00,ITA,11,43.61675973,13.5188753,12,5,17,8,25,14,0,0,25,101,,,Marche,1538055
313,2020-03-02T18:00:00,ITA,11,43.61675973,13.5188753,17,6,23,11,34,9,0,1,35,137,,,Marche,1538055
314,2020-03-03T18:00:00,ITA,11,43.61675973,13.5188753,27,13,40,19,59,25,0,2,61,200,,,Marche,1538055
315,2020-03-04T17:00:00,ITA,11,43.61675973,13.5188753,34,15,49,31,80,21,0,4,84,288,,,Marche,1538055
316,2020-03-05T17:00:00,ITA,11,43.61675973,13.5188753,57,19,76,44,120,40,0,4,124,413,,,Marche,1538055
317,2020-03-06T17:00:00,ITA,11,43.61675973,13.5188753,73,20,93,62,155,35,0,4,159,585,,,Marche,1538055
318,2020-03-07T18:00:00,ITA,11,43.61675973,13.5188753,94,36,130,71,201,46,0,6,207,816,,,Marche,1538055
319,2020-03-08T18:00:00,ITA,11,43.61675973,13.5188753,110,41,151,114,265,64,0,7,272,1025,,,Marche,1538055
320,2020-03-09T18:00:00,ITA,11,43.61675973,13.5188753,136,47,183,130,313,48,0,10,323,1250,,,Marche,1538055
321,2020-03-10T18:00:00,ITA,11,43.61675973,13.5188753,152,54,206,175,381,68,0,13,394,1437,,,Marche,1538055
322,2020-03-11T17:00:00,ITA,11,43.61675973,13.5188753,212,66,278,183,461,80,0,18,479,1656,,,Marche,1538055
323,2020-03-12T17:00:00,ITA,11,43.61675973,13.5188753,254,76,330,240,570,109,0,22,592,1907,,,Marche,1538055
324,2020-03-13T17:00:00,ITA,11,43.61675973,13.5188753,337,85,422,276,698,128,0,27,725,2218,,,Marche,1538055
325,2020-03-14T17:00:00,ITA,11,43.61675973,13.5188753,449,93,542,321,863,165,0,36,899,2561,,,Marche,1538055
326,2020-03-15T17:00:00,ITA,11,43.61675973,13.5188753,521,98,619,468,1087,224,0,46,1133,2946,,,Marche,1538055
327,2020-03-16T17:00:00,ITA,11,43.61675973,13.5188753,528,110,638,547,1185,98,0,57,1242,3225,,,Marche,1538055
328,2020-03-17T17:00:00,ITA,11,43.61675973,13.5188753,599,109,708,594,1302,117,0,69,1371,3225,,,Marche,1538055
329,2020-03-18T17:00:00,ITA,11,43.61675973,13.5188753,638,119,757,719,1476,174,0,92,1568,4109,,,Marche,1538055
330,2020-03-19T17:00:00,ITA,11,43.61675973,13.5188753,656,141,797,825,1622,146,0,115,1737,4512,,,Marche,1538055
331,2020-03-20T17:00:00,ITA,11,43.61675973,13.5188753,704,138,842,1002,1844,222,0,137,1981,5170,,,Marche,1538055
332,2020-03-21T17:00:00,ITA,11,43.61675973,13.5188753,742,141,883,1114,1997,153,2,154,2153,5740,,,Marche,1538055
333,2020-03-22T17:00:00,ITA,11,43.61675973,13.5188753,816,138,954,1277,2231,234,6,184,2421,6391,,,Marche,1538055
334,2020-03-23T17:00:00,ITA,11,43.61675973,13.5188753,882,148,1030,1328,2358,127,8,203,2569,6782,,,Marche,1538055
335,2020-03-24T17:00:00,ITA,11,43.61675973,13.5188753,862,149,1011,1486,2497,139,8,231,2736,7229,,,Marche,1538055
336,2020-03-25T17:00:00,ITA,11,43.61675973,13.5188753,938,148,1086,1553,2639,142,8,287,2934,7896,,,Marche,1538055
337,2020-03-26T17:00:00,ITA,11,43.61675973,13.5188753,977,166,1143,1652,2795,156,9,310,3114,8623,,,Marche,1538055
338,2020-03-27T17:00:00,ITA,11,43.61675973,13.5188753,979,162,1141,1709,2850,55,10,336,3196,9060,,,Marche,1538055
339,2020-03-28T17:00:00,ITA,11,43.61675973,13.5188753,987,166,1153,1846,2999,149,10,364,3373,9884,,,Marche,1538055
340,2020-02-24T18:00:00,ITA,14,41.55774754,14.65916051,0,0,0,0,0,0,0,0,0,0,,,Molise,310449
341,2020-02-25T18:00:00,ITA,14,41.55774754,14.65916051,0,0,0,0,0,0,0,0,0,0,,,Molise,310449
342,2020-02-26T18:00:00,ITA,14,41.55774754,14.65916051,0,0,0,0,0,0,0,0,0,0,,,Molise,310449
343,2020-02-27T18:00:00,ITA,14,41.55774754,14.65916051,0,0,0,0,0,0,0,0,0,0,,,Molise,310449
344,2020-02-28T18:00:00,ITA,14,41.55774754,14.65916051,0,0,0,0,0,0,0,0,0,0,,,Molise,310449
345,2020-02-29T17:00:00,ITA,14,41.55774754,14.65916051,0,0,0,0,0,0,0,0,0,0,,,Molise,310449
346,2020-03-01T17:00:00,ITA,14,41.55774754,14.65916051,0,0,0,0,0,0,0,0,0,6,,,Molise,310449
347,2020-03-02T18:00:00,ITA,14,41.55774754,14.65916051,0,0,0,0,0,0,0,0,0,13,,,Molise,310449
348,2020-03-03T18:00:00,ITA,14,41.55774754,14.65916051,3,0,3,0,3,3,0,0,3,13,,,Molise,310449
349,2020-03-04T17:00:00,ITA,14,41.55774754,14.65916051,3,0,3,0,3,0,0,0,3,19,,,Molise,310449
350,2020-03-05T17:00:00,ITA,14,41.55774754,14.65916051,4,0,4,3,7,4,0,0,7,24,,,Molise,310449
351,2020-03-06T17:00:00,ITA,14,41.55774754,14.65916051,3,2,5,7,12,5,0,0,12,104,,,Molise,310449
352,2020-03-07T18:00:00,ITA,14,41.55774754,14.65916051,3,2,5,9,14,2,0,0,14,112,,,Molise,310449
353,2020-03-08T18:00:00,ITA,14,41.55774754,14.65916051,4,2,6,8,14,0,0,0,14,116,,,Molise,310449
354,2020-03-09T18:00:00,ITA,14,41.55774754,14.65916051,4,2,6,8,14,0,0,0,14,212,,,Molise,310449
355,2020-03-10T18:00:00,ITA,14,41.55774754,14.65916051,3,3,6,9,15,1,0,0,15,225,,,Molise,310449
356,2020-03-11T17:00:00,ITA,14,41.55774754,14.65916051,4,3,7,9,16,1,0,0,16,233,,,Molise,310449
357,2020-03-12T17:00:00,ITA,14,41.55774754,14.65916051,4,3,7,9,16,0,0,0,16,238,,,Molise,310449
358,2020-03-13T17:00:00,ITA,14,41.55774754,14.65916051,5,3,8,9,17,1,0,0,17,243,,,Molise,310449
359,2020-03-14T17:00:00,ITA,14,41.55774754,14.65916051,5,3,8,9,17,0,0,0,17,247,,,Molise,310449
360,2020-03-15T17:00:00,ITA,14,41.55774754,14.65916051,3,4,7,10,17,0,0,0,17,248,,,Molise,310449
361,2020-03-16T17:00:00,ITA,14,41.55774754,14.65916051,3,5,8,7,15,-2,5,1,21,253,,,Molise,310449
362,2020-03-17T17:00:00,ITA,14,41.55774754,14.65916051,7,5,12,7,19,4,5,1,25,301,,,Molise,310449
363,2020-03-18T17:00:00,ITA,14,41.55774754,14.65916051,7,6,13,8,21,2,6,1,28,361,,,Molise,310449
364,2020-03-19T17:00:00,ITA,14,41.55774754,14.65916051,19,6,25,13,38,17,6,2,46,426,,,Molise,310449
365,2020-03-20T17:00:00,ITA,14,41.55774754,14.65916051,20,6,26,13,39,1,6,5,50,426,,,Molise,310449
366,2020-03-21T17:00:00,ITA,14,41.55774754,14.65916051,21,6,27,20,47,8,7,7,61,449,,,Molise,310449
367,2020-03-22T17:00:00,ITA,14,41.55774754,14.65916051,24,7,31,21,52,5,7,7,66,532,,,Molise,310449
368,2020-03-23T17:00:00,ITA,14,41.55774754,14.65916051,25,7,32,18,50,-2,10,7,67,532,,,Molise,310449
369,2020-03-24T17:00:00,ITA,14,41.55774754,14.65916051,27,7,34,21,55,5,10,8,73,572,,,Molise,310449
370,2020-03-25T17:00:00,ITA,14,41.55774754,14.65916051,26,7,33,20,53,-2,12,8,73,580,,,Molise,310449
371,2020-03-26T17:00:00,ITA,14,41.55774754,14.65916051,27,8,35,46,81,28,14,8,103,670,,,Molise,310449
372,2020-03-27T17:00:00,ITA,14,41.55774754,14.65916051,26,9,35,51,86,5,14,9,109,710,,,Molise,310449
373,2020-03-28T17:00:00,ITA,14,41.55774754,14.65916051,26,9,35,63,98,12,16,9,123,807,,,Molise,310449
374,2020-02-24T18:00:00,ITA,1,45.0732745,7.680687483,2,0,2,1,3,3,0,0,3,141,,,Piemonte,4392526
375,2020-02-25T18:00:00,ITA,1,45.0732745,7.680687483,2,0,2,1,3,0,0,0,3,141,,,Piemonte,4392526
376,2020-02-26T18:00:00,ITA,1,45.0732745,7.680687483,2,0,2,1,3,0,0,0,3,156,,,Piemonte,4392526
377,2020-02-27T18:00:00,ITA,1,45.0732745,7.680687483,2,0,2,0,2,-1,0,0,2,156,,,Piemonte,4392526
378,2020-02-28T18:00:00,ITA,1,45.0732745,7.680687483,7,0,7,4,11,9,0,0,11,227,,,Piemonte,4392526
379,2020-02-29T17:00:00,ITA,1,45.0732745,7.680687483,7,0,7,4,11,0,0,0,11,308,,,Piemonte,4392526
380,2020-03-01T17:00:00,ITA,1,45.0732745,7.680687483,11,2,13,36,49,38,0,0,49,362,,,Piemonte,4392526
381,2020-03-02T18:00:00,ITA,1,45.0732745,7.680687483,12,2,14,37,51,2,0,0,51,434,,,Piemonte,4392526
382,2020-03-03T18:00:00,ITA,1,45.0732745,7.680687483,13,3,16,40,56,5,0,0,56,458,,,Piemonte,4392526
383,2020-03-04T17:00:00,ITA,1,45.0732745,7.680687483,26,13,39,43,82,26,0,0,82,543,,,Piemonte,4392526
384,2020-03-05T17:00:00,ITA,1,45.0732745,7.680687483,43,17,60,46,106,24,0,2,108,543,,,Piemonte,4392526
385,2020-03-06T17:00:00,ITA,1,45.0732745,7.680687483,57,30,87,52,139,33,0,4,143,793,,,Piemonte,4392526
386,2020-03-07T18:00:00,ITA,1,45.0732745,7.680687483,110,38,148,54,202,63,0,5,207,1046,,,Piemonte,4392526
387,2020-03-08T18:00:00,ITA,1,45.0732745,7.680687483,245,45,290,65,355,153,0,5,360,1636,,,Piemonte,4392526
388,2020-03-09T18:00:00,ITA,1,45.0732745,7.680687483,222,50,272,65,337,-18,0,13,350,1681,,,Piemonte,4392526
389,2020-03-10T18:00:00,ITA,1,45.0732745,7.680687483,306,66,372,64,436,99,0,17,453,2374,,,Piemonte,4392526
390,2020-03-11T17:00:00,ITA,1,45.0732745,7.680687483,319,75,394,86,480,44,0,21,501,2431,,,Piemonte,4392526
391,2020-03-12T17:00:00,ITA,1,45.0732745,7.680687483,368,97,465,89,554,74,0,26,580,2879,,,Piemonte,4392526
392,2020-03-13T17:00:00,ITA,1,45.0732745,7.680687483,556,135,691,103,794,240,0,46,840,3105,,,Piemonte,4392526
393,2020-03-14T17:00:00,ITA,1,45.0732745,7.680687483,538,150,688,126,814,20,0,59,873,3680,,,Piemonte,4392526
394,2020-03-15T17:00:00,ITA,1,45.0732745,7.680687483,726,171,897,133,1030,216,0,81,1111,4375,,,Piemonte,4392526
395,2020-03-16T17:00:00,ITA,1,45.0732745,7.680687483,1045,186,1231,174,1405,375,0,111,1516,5588,,,Piemonte,4392526
396,2020-03-17T17:00:00,ITA,1,45.0732745,7.680687483,1378,206,1584,180,1764,359,0,133,1897,6543,,,Piemonte,4392526
397,2020-03-18T17:00:00,ITA,1,45.0732745,7.680687483,1780,227,2007,180,2187,423,0,154,2341,7516,,,Piemonte,4392526
398,2020-03-19T17:00:00,ITA,1,45.0732745,7.680687483,2279,257,2536,218,2754,567,3,175,2932,8853,,,Piemonte,4392526
399,2020-03-20T17:00:00,ITA,1,45.0732745,7.680687483,1541,280,1821,1423,3244,490,8,209,3461,9975,,,Piemonte,4392526
400,2020-03-21T17:00:00,ITA,1,45.0732745,7.680687483,1976,301,2277,1229,3506,262,8,238,3752,10701,,,Piemonte,4392526
401,2020-03-22T17:00:00,ITA,1,45.0732745,7.680687483,2118,308,2426,1701,4127,621,10,283,4420,12701,,,Piemonte,4392526
402,2020-03-23T17:00:00,ITA,1,45.0732745,7.680687483,2194,343,2537,1992,4529,402,17,315,4861,13560,,,Piemonte,4392526
403,2020-03-24T17:00:00,ITA,1,45.0732745,7.680687483,2404,360,2764,2360,5124,595,17,374,5515,15469,,,Piemonte,4392526
404,2020-03-25T17:00:00,ITA,1,45.0732745,7.680687483,2544,381,2925,2631,5556,432,19,449,6024,16655,,,Piemonte,4392526
405,2020-03-26T17:00:00,ITA,1,45.0732745,7.680687483,2633,408,3041,2909,5950,394,135,449,6534,18054,pd-IT-0006,pd-EN-0006,Piemonte,4392526
406,2020-03-27T17:00:00,ITA,1,45.0732745,7.680687483,2852,431,3283,3064,6347,397,176,569,7092,19705,,,Piemonte,4392526
407,2020-03-28T17:00:00,ITA,1,45.0732745,7.680687483,3094,439,3533,3318,6851,504,203,617,7671,21511,,,Piemonte,4392526
408,2020-02-24T18:00:00,ITA,16,41.12559576,16.86736689,0,0,0,0,0,0,0,0,0,0,,,Puglia,4063888
409,2020-02-25T18:00:00,ITA,16,41.12559576,16.86736689,0,0,0,0,0,0,0,0,0,0,,,Puglia,4063888
410,2020-02-26T18:00:00,ITA,16,41.12559576,16.86736689,0,0,0,0,0,0,0,0,0,0,,,Puglia,4063888
411,2020-02-27T18:00:00,ITA,16,41.12559576,16.86736689,1,0,1,0,1,1,0,0,1,0,,,Puglia,4063888
412,2020-02-28T18:00:00,ITA,16,41.12559576,16.86736689,1,0,1,2,3,2,0,0,3,242,,,Puglia,4063888
413,2020-02-29T17:00:00,ITA,16,41.12559576,16.86736689,1,0,1,2,3,0,0,0,3,252,,,Puglia,4063888
414,2020-03-01T17:00:00,ITA,16,41.12559576,16.86736689,1,0,1,2,3,0,0,0,3,262,,,Puglia,4063888
415,2020-03-02T18:00:00,ITA,16,41.12559576,16.86736689,2,0,2,2,4,1,0,0,4,278,,,Puglia,4063888
416,2020-03-03T18:00:00,ITA,16,41.12559576,16.86736689,2,0,2,4,6,2,0,0,6,298,,,Puglia,4063888
417,2020-03-04T17:00:00,ITA,16,41.12559576,16.86736689,4,0,4,3,7,1,1,1,9,322,,,Puglia,4063888
418,2020-03-05T17:00:00,ITA,16,41.12559576,16.86736689,5,1,6,6,12,5,1,1,14,359,,,Puglia,4063888
419,2020-03-06T17:00:00,ITA,16,41.12559576,16.86736689,5,1,6,9,15,3,1,1,17,395,,,Puglia,4063888
420,2020-03-07T18:00:00,ITA,16,41.12559576,16.86736689,9,2,11,12,23,8,1,2,26,395,,,Puglia,4063888
421,2020-03-08T18:00:00,ITA,16,41.12559576,16.86736689,17,3,20,16,36,13,1,3,40,627,,,Puglia,4063888
422,2020-03-09T18:00:00,ITA,16,41.12559576,16.86736689,20,6,26,20,46,10,1,3,50,685,,,Puglia,4063888
423,2020-03-10T18:00:00,ITA,16,41.12559576,16.86736689,28,6,34,21,55,9,1,3,59,747,,,Puglia,4063888
424,2020-03-11T17:00:00,ITA,16,41.12559576,16.86736689,38,4,42,29,71,16,1,5,77,909,,,Puglia,4063888
425,2020-03-12T17:00:00,ITA,16,41.12559576,16.86736689,58,2,60,38,98,27,1,5,104,1269,,,Puglia,4063888
426,2020-03-13T17:00:00,ITA,16,41.12559576,16.86736689,77,2,79,42,121,23,3,5,129,1449,,,Puglia,4063888
427,2020-03-14T17:00:00,ITA,16,41.12559576,16.86736689,91,6,97,59,156,35,2,8,166,1681,,,Puglia,4063888
428,2020-03-15T17:00:00,ITA,16,41.12559576,16.86736689,116,6,122,90,212,56,2,16,230,2017,,,Puglia,4063888
429,2020-03-16T17:00:00,ITA,16,41.12559576,16.86736689,116,6,122,90,212,0,2,16,230,2017,nd-IT-0005,nd-EN-0005,Puglia,4063888
430,2020-03-17T17:00:00,ITA,16,41.12559576,16.86736689,155,14,169,151,320,108,2,18,340,3077,,,Puglia,4063888
431,2020-03-18T17:00:00,ITA,16,41.12559576,16.86736689,156,30,186,176,362,42,2,19,383,3433,,,Puglia,4063888
432,2020-03-19T17:00:00,ITA,16,41.12559576,16.86736689,173,31,204,245,449,87,4,25,478,4046,,,Puglia,4063888
433,2020-03-20T17:00:00,ITA,16,41.12559576,16.86736689,191,31,222,329,551,102,4,26,581,4789,,,Puglia,4063888
434,2020-03-21T17:00:00,ITA,16,41.12559576,16.86736689,209,33,242,400,642,91,4,29,675,5617,,,Puglia,4063888
435,2020-03-22T17:00:00,ITA,16,41.12559576,16.86736689,252,37,289,459,748,106,7,31,786,6160,,,Puglia,4063888
436,2020-03-23T17:00:00,ITA,16,41.12559576,16.86736689,285,45,330,532,862,114,7,37,906,6761,,,Puglia,4063888
437,2020-03-24T17:00:00,ITA,16,41.12559576,16.86736689,317,57,374,566,940,78,21,44,1005,7345,,,Puglia,4063888
438,2020-03-25T17:00:00,ITA,16,41.12559576,16.86736689,349,64,413,610,1023,83,22,48,1093,8223,,,Puglia,4063888
439,2020-03-26T17:00:00,ITA,16,41.12559576,16.86736689,480,76,556,539,1095,72,22,65,1182,9191,,,Puglia,4063888
440,2020-03-27T17:00:00,ITA,16,41.12559576,16.86736689,530,82,612,624,1236,141,29,69,1334,10233,,,Puglia,4063888
441,2020-03-28T17:00:00,ITA,16,41.12559576,16.86736689,563,98,661,697,1358,122,29,71,1458,11500,,,Puglia,4063888
442,2020-02-24T18:00:00,ITA,20,39.21531192,9.110616306,0,0,0,0,0,0,0,0,0,1,,,Sardegna,1653135
443,2020-02-25T18:00:00,ITA,20,39.21531192,9.110616306,0,0,0,0,0,0,0,0,0,1,,,Sardegna,1653135
444,2020-02-26T18:00:00,ITA,20,39.21531192,9.110616306,0,0,0,0,0,0,0,0,0,1,,,Sardegna,1653135
445,2020-02-27T18:00:00,ITA,20,39.21531192,9.110616306,0,0,0,0,0,0,0,0,0,1,,,Sardegna,1653135
446,2020-02-28T18:00:00,ITA,20,39.21531192,9.110616306,0,0,0,0,0,0,0,0,0,1,,,Sardegna,1653135
447,2020-02-29T17:00:00,ITA,20,39.21531192,9.110616306,0,0,0,0,0,0,0,0,0,1,,,Sardegna,1653135
448,2020-03-01T17:00:00,ITA,20,39.21531192,9.110616306,0,0,0,0,0,0,0,0,0,29,,,Sardegna,1653135
449,2020-03-02T18:00:00,ITA,20,39.21531192,9.110616306,0,0,0,0,0,0,0,0,0,29,,,Sardegna,1653135
450,2020-03-03T18:00:00,ITA,20,39.21531192,9.110616306,1,0,1,0,1,1,0,0,1,29,,,Sardegna,1653135
451,2020-03-04T17:00:00,ITA,20,39.21531192,9.110616306,1,0,1,1,2,1,0,0,2,42,,,Sardegna,1653135
452,2020-03-05T17:00:00,ITA,20,39.21531192,9.110616306,2,0,2,0,2,0,0,0,2,50,,,Sardegna,1653135
453,2020-03-06T17:00:00,ITA,20,39.21531192,9.110616306,2,0,2,3,5,3,0,0,5,99,,,Sardegna,1653135
454,2020-03-07T18:00:00,ITA,20,39.21531192,9.110616306,2,0,2,3,5,0,0,0,5,99,,,Sardegna,1653135
455,2020-03-08T18:00:00,ITA,20,39.21531192,9.110616306,5,0,5,6,11,6,0,0,11,149,,,Sardegna,1653135
456,2020-03-09T18:00:00,ITA,20,39.21531192,9.110616306,8,0,8,11,19,8,0,0,19,185,,,Sardegna,1653135
457,2020-03-10T18:00:00,ITA,20,39.21531192,9.110616306,9,0,9,11,20,1,0,0,20,204,,,Sardegna,1653135
458,2020-03-11T17:00:00,ITA,20,39.21531192,9.110616306,10,0,10,27,37,17,0,0,37,283,,,Sardegna,1653135
459,2020-03-12T17:00:00,ITA,20,39.21531192,9.110616306,12,0,12,27,39,2,0,0,39,302,,,Sardegna,1653135
460,2020-03-13T17:00:00,ITA,20,39.21531192,9.110616306,12,0,12,31,43,4,0,0,43,504,,,Sardegna,1653135
461,2020-03-14T17:00:00,ITA,20,39.21531192,9.110616306,14,0,14,33,47,4,0,0,47,530,,,Sardegna,1653135
462,2020-03-15T17:00:00,ITA,20,39.21531192,9.110616306,16,0,16,59,75,28,0,2,77,613,,,Sardegna,1653135
463,2020-03-16T17:00:00,ITA,20,39.21531192,9.110616306,39,0,39,66,105,30,0,2,107,797,,,Sardegna,1653135
464,2020-03-17T17:00:00,ITA,20,39.21531192,9.110616306,36,4,40,75,115,10,0,2,117,1003,,,Sardegna,1653135
465,2020-03-18T17:00:00,ITA,20,39.21531192,9.110616306,42,7,49,83,132,17,0,2,134,1135,,,Sardegna,1653135
466,2020-03-19T17:00:00,ITA,20,39.21531192,9.110616306,43,9,52,152,204,72,0,2,206,1334,,,Sardegna,1653135
467,2020-03-20T17:00:00,ITA,20,39.21531192,9.110616306,56,15,71,217,288,84,3,2,293,1912,,,Sardegna,1653135
468,2020-03-21T17:00:00,ITA,20,39.21531192,9.110616306,65,16,81,240,321,33,5,4,330,2297,,,Sardegna,1653135
469,2020-03-22T17:00:00,ITA,20,39.21531192,9.110616306,67,16,83,244,327,6,5,7,339,2402,,,Sardegna,1653135
470,2020-03-23T17:00:00,ITA,20,39.21531192,9.110616306,76,18,94,249,343,16,5,11,359,2568,,,Sardegna,1653135
471,2020-03-24T17:00:00,ITA,20,39.21531192,9.110616306,80,19,99,296,395,52,11,15,421,2859,,,Sardegna,1653135
472,2020-03-25T17:00:00,ITA,20,39.21531192,9.110616306,82,19,101,311,412,17,12,18,442,3019,,,Sardegna,1653135
473,2020-03-26T17:00:00,ITA,20,39.21531192,9.110616306,92,20,112,350,462,50,13,19,494,3461,,,Sardegna,1653135
474,2020-03-27T17:00:00,ITA,20,39.21531192,9.110616306,93,19,112,384,496,34,13,21,530,3801,,,Sardegna,1653135
475,2020-03-28T17:00:00,ITA,20,39.21531192,9.110616306,95,22,117,452,569,73,29,26,624,4225,,,Sardegna,1653135
476,2020-02-24T18:00:00,ITA,19,38.11569725,13.362356699999998,0,0,0,0,0,0,0,0,0,5,,,Sicilia,5056641
477,2020-02-25T18:00:00,ITA,19,38.11569725,13.362356699999998,1,0,2,2,3,3,0,0,3,5,,,Sicilia,5056641
478,2020-02-26T18:00:00,ITA,19,38.11569725,13.362356699999998,1,0,1,2,3,0,0,0,3,5,,,Sicilia,5056641
479,2020-02-27T18:00:00,ITA,19,38.11569725,13.362356699999998,1,0,1,1,2,-1,2,0,4,5,,,Sicilia,5056641
480,2020-02-28T18:00:00,ITA,19,38.11569725,13.362356699999998,1,0,1,1,2,0,2,0,4,5,,,Sicilia,5056641
481,2020-02-29T17:00:00,ITA,19,38.11569725,13.362356699999998,1,0,1,1,2,0,2,0,4,6,,,Sicilia,5056641
482,2020-03-01T17:00:00,ITA,19,38.11569725,13.362356699999998,1,0,1,6,7,5,2,0,9,291,,,Sicilia,5056641
483,2020-03-02T18:00:00,ITA,19,38.11569725,13.362356699999998,2,0,2,3,5,-2,2,0,7,307,,,Sicilia,5056641
484,2020-03-03T18:00:00,ITA,19,38.11569725,13.362356699999998,2,0,2,3,5,0,2,0,7,307,,,Sicilia,5056641
485,2020-03-04T17:00:00,ITA,19,38.11569725,13.362356699999998,5,0,5,11,16,11,2,0,18,367,,,Sicilia,5056641
486,2020-03-05T17:00:00,ITA,19,38.11569725,13.362356699999998,5,0,5,11,16,0,2,0,18,367,,,Sicilia,5056641
487,2020-03-06T17:00:00,ITA,19,38.11569725,13.362356699999998,7,0,7,15,22,6,2,0,24,367,,,Sicilia,5056641
488,2020-03-07T18:00:00,ITA,19,38.11569725,13.362356699999998,8,0,8,25,33,11,2,0,35,643,,,Sicilia,5056641
489,2020-03-08T18:00:00,ITA,19,38.11569725,13.362356699999998,18,0,18,33,51,18,2,0,53,791,,,Sicilia,5056641
490,2020-03-09T18:00:00,ITA,19,38.11569725,13.362356699999998,19,0,19,33,52,1,2,0,54,836,,,Sicilia,5056641
491,2020-03-10T18:00:00,ITA,19,38.11569725,13.362356699999998,17,2,19,41,60,8,2,0,62,955,,,Sicilia,5056641
492,2020-03-11T17:00:00,ITA,19,38.11569725,13.362356699999998,23,1,24,57,81,21,2,0,83,1194,,,Sicilia,5056641
493,2020-03-12T17:00:00,ITA,19,38.11569725,13.362356699999998,28,5,33,78,111,30,2,2,115,1477,,,Sicilia,5056641
494,2020-03-13T17:00:00,ITA,19,38.11569725,13.362356699999998,37,7,44,82,126,15,2,2,130,1950,,,Sicilia,5056641
495,2020-03-14T17:00:00,ITA,19,38.11569725,13.362356699999998,42,11,53,97,150,24,4,2,156,2100,,,Sicilia,5056641
496,2020-03-15T17:00:00,ITA,19,38.11569725,13.362356699999998,56,15,71,108,179,29,7,2,188,2452,,,Sicilia,5056641
497,2020-03-16T17:00:00,ITA,19,38.11569725,13.362356699999998,75,20,95,108,203,24,8,2,213,2653,,,Sicilia,5056641
498,2020-03-17T17:00:00,ITA,19,38.11569725,13.362356699999998,86,28,114,112,226,23,8,3,237,2916,,,Sicilia,5056641
499,2020-03-18T17:00:00,ITA,19,38.11569725,13.362356699999998,100,29,129,138,267,41,12,3,282,3294,,,Sicilia,5056641
500,2020-03-19T17:00:00,ITA,19,38.11569725,13.362356699999998,143,36,179,142,321,54,15,4,340,3961,,,Sicilia,5056641
501,2020-03-20T17:00:00,ITA,19,38.11569725,13.362356699999998,168,42,210,169,379,58,25,4,408,4468,,,Sicilia,5056641
502,2020-03-21T17:00:00,ITA,19,38.11569725,13.362356699999998,206,48,254,204,458,79,26,6,490,4883,,,Sicilia,5056641
503,2020-03-22T17:00:00,ITA,19,38.11569725,13.362356699999998,220,55,275,321,596,138,26,8,630,5580,,,Sicilia,5056641
504,2020-03-23T17:00:00,ITA,19,38.11569725,13.362356699999998,250,60,310,371,681,85,27,13,721,6375,,,Sicilia,5056641
505,2020-03-24T17:00:00,ITA,19,38.11569725,13.362356699999998,250,60,310,489,799,118,27,20,846,7170,,,Sicilia,5056641
506,2020-03-25T17:00:00,ITA,19,38.11569725,13.362356699999998,259,80,339,597,936,137,33,25,994,8312,,,Sicilia,5056641
507,2020-03-26T17:00:00,ITA,19,38.11569725,13.362356699999998,346,68,414,681,1095,159,36,33,1164,9658,,,Sicilia,5056641
508,2020-03-27T17:00:00,ITA,19,38.11569725,13.362356699999998,425,75,500,658,1158,63,53,39,1250,11079,,,Sicilia,5056641
509,2020-03-28T17:00:00,ITA,19,38.11569725,13.362356699999998,441,71,512,730,1242,84,60,57,1359,13096,,,Sicilia,5056641
510,2020-02-24T18:00:00,ITA,9,43.76923077,11.25588885,0,0,0,0,0,0,0,0,0,140,,,Toscana,3742437
511,2020-02-25T18:00:00,ITA,9,43.76923077,11.25588885,2,0,2,0,2,2,0,0,2,296,,,Toscana,3742437
512,2020-02-26T18:00:00,ITA,9,43.76923077,11.25588885,2,0,2,0,2,0,0,0,2,363,,,Toscana,3742437
513,2020-02-27T18:00:00,ITA,9,43.76923077,11.25588885,2,0,2,0,2,0,0,0,2,410,,,Toscana,3742437
514,2020-02-28T18:00:00,ITA,9,43.76923077,11.25588885,5,0,5,2,7,5,1,0,8,437,,,Toscana,3742437
515,2020-02-29T17:00:00,ITA,9,43.76923077,11.25588885,7,0,7,3,10,3,1,0,11,531,,,Toscana,3742437
516,2020-03-01T17:00:00,ITA,9,43.76923077,11.25588885,7,0,7,5,12,2,1,0,13,572,,,Toscana,3742437
517,2020-03-02T18:00:00,ITA,9,43.76923077,11.25588885,7,0,7,5,12,0,1,0,13,613,,,Toscana,3742437
518,2020-03-03T18:00:00,ITA,9,43.76923077,11.25588885,10,0,10,8,18,6,1,0,19,697,,,Toscana,3742437
519,2020-03-04T17:00:00,ITA,9,43.76923077,11.25588885,15,2,17,20,37,19,1,0,38,776,,,Toscana,3742437
520,2020-03-05T17:00:00,ITA,9,43.76923077,11.25588885,26,3,29,31,60,23,1,0,61,776,,,Toscana,3742437
521,2020-03-06T17:00:00,ITA,9,43.76923077,11.25588885,35,5,40,38,78,18,1,0,79,1097,,,Toscana,3742437
522,2020-03-07T18:00:00,ITA,9,43.76923077,11.25588885,54,7,61,51,112,34,1,0,113,1331,,,Toscana,3742437
523,2020-03-08T18:00:00,ITA,9,43.76923077,11.25588885,91,7,98,67,165,53,1,0,166,1618,,,Toscana,3742437
524,2020-03-09T18:00:00,ITA,9,43.76923077,11.25588885,107,9,116,90,206,41,1,1,208,2018,,,Toscana,3742437
525,2020-03-10T18:00:00,ITA,9,43.76923077,11.25588885,91,40,131,129,260,54,3,1,264,2573,,,Toscana,3742437
526,2020-03-11T17:00:00,ITA,9,43.76923077,11.25588885,87,54,141,173,314,54,5,1,320,2804,,,Toscana,3742437
527,2020-03-12T17:00:00,ITA,9,43.76923077,11.25588885,100,59,159,193,352,38,7,5,364,3165,,,Toscana,3742437
528,2020-03-13T17:00:00,ITA,9,43.76923077,11.25588885,134,77,211,244,455,103,10,5,470,4049,,,Toscana,3742437
529,2020-03-14T17:00:00,ITA,9,43.76923077,11.25588885,160,87,247,367,614,159,10,6,630,4595,,,Toscana,3742437
530,2020-03-15T17:00:00,ITA,9,43.76923077,11.25588885,175,107,282,481,763,149,10,8,781,5132,,,Toscana,3742437
531,2020-03-16T17:00:00,ITA,9,43.76923077,11.25588885,175,107,282,559,841,78,11,14,866,5910,,,Toscana,3742437
532,2020-03-17T17:00:00,ITA,9,43.76923077,11.25588885,329,143,472,552,1024,183,12,17,1053,6727,,,Toscana,3742437
533,2020-03-18T17:00:00,ITA,9,43.76923077,11.25588885,427,160,587,704,1291,267,17,22,1330,7606,,,Toscana,3742437
534,2020-03-19T17:00:00,ITA,9,43.76923077,11.25588885,501,178,679,743,1422,131,22,38,1482,8873,,,Toscana,3742437
535,2020-03-20T17:00:00,ITA,9,43.76923077,11.25588885,601,189,790,923,1713,291,33,47,1793,10405,,,Toscana,3742437
536,2020-03-21T17:00:00,ITA,9,43.76923077,11.25588885,664,202,866,1039,1905,192,35,72,2012,11909,,,Toscana,3742437
537,2020-03-22T17:00:00,ITA,9,43.76923077,11.25588885,706,215,921,1223,2144,239,42,91,2277,13264,,,Toscana,3742437
538,2020-03-23T17:00:00,ITA,9,43.76923077,11.25588885,838,238,1076,1225,2301,157,51,109,2461,13851,,,Toscana,3742437
539,2020-03-24T17:00:00,ITA,9,43.76923077,11.25588885,918,244,1162,1357,2519,218,51,129,2699,15701,,,Toscana,3742437
540,2020-03-25T17:00:00,ITA,9,43.76923077,11.25588885,999,251,1250,1526,2776,257,54,142,2972,17868,,,Toscana,3742437
541,2020-03-26T17:00:00,ITA,9,43.76923077,11.25588885,1037,259,1296,1677,2973,197,95,158,3226,20952,,,Toscana,3742437
542,2020-03-27T17:00:00,ITA,9,43.76923077,11.25588885,1053,274,1327,1843,3170,197,103,177,3450,23746,,,Toscana,3742437
543,2020-03-28T17:00:00,ITA,9,43.76923077,11.25588885,1093,277,1370,2141,3511,341,108,198,3817,25613,,,Toscana,3742437
544,2020-02-24T18:00:00,ITA,10,43.10675841,12.38824698,0,0,0,0,0,0,0,0,0,0,,,Umbria,888908
545,2020-02-25T18:00:00,ITA,10,43.10675841,12.38824698,0,0,0,0,0,0,0,0,0,8,,,Umbria,888908
546,2020-02-26T18:00:00,ITA,10,43.10675841,12.38824698,0,0,0,0,0,0,0,0,0,8,,,Umbria,888908
547,2020-02-27T18:00:00,ITA,10,43.10675841,12.38824698,0,0,0,0,0,0,0,0,0,8,,,Umbria,888908
548,2020-02-28T18:00:00,ITA,10,43.10675841,12.38824698,0,0,0,0,0,0,0,0,0,8,,,Umbria,888908
549,2020-02-29T17:00:00,ITA,10,43.10675841,12.38824698,0,0,0,0,0,0,0,0,0,31,,,Umbria,888908
550,2020-03-01T17:00:00,ITA,10,43.10675841,12.38824698,0,0,0,2,2,2,0,0,2,35,,,Umbria,888908
551,2020-03-02T18:00:00,ITA,10,43.10675841,12.38824698,0,0,0,2,2,0,0,0,2,35,,,Umbria,888908
552,2020-03-03T18:00:00,ITA,10,43.10675841,12.38824698,1,1,2,6,8,6,0,0,8,45,,,Umbria,888908
553,2020-03-04T17:00:00,ITA,10,43.10675841,12.38824698,1,1,2,7,9,1,0,0,9,58,,,Umbria,888908
554,2020-03-05T17:00:00,ITA,10,43.10675841,12.38824698,1,1,2,7,9,0,0,0,9,88,,,Umbria,888908
555,2020-03-06T17:00:00,ITA,10,43.10675841,12.38824698,2,2,4,12,16,7,0,0,16,110,,,Umbria,888908
556,2020-03-07T18:00:00,ITA,10,43.10675841,12.38824698,2,2,4,20,24,8,0,0,24,134,,,Umbria,888908
557,2020-03-08T18:00:00,ITA,10,43.10675841,12.38824698,2,2,4,22,26,2,0,0,26,168,,,Umbria,888908
558,2020-03-09T18:00:00,ITA,10,43.10675841,12.38824698,4,2,6,22,28,2,0,0,28,183,,,Umbria,888908
559,2020-03-10T18:00:00,ITA,10,43.10675841,12.38824698,8,2,10,27,37,9,0,0,37,260,,,Umbria,888908
560,2020-03-11T17:00:00,ITA,10,43.10675841,12.38824698,7,5,12,32,44,7,2,0,46,340,,,Umbria,888908
561,2020-03-12T17:00:00,ITA,10,43.10675841,12.38824698,8,8,16,46,62,18,2,0,64,458,,,Umbria,888908
562,2020-03-13T17:00:00,ITA,10,43.10675841,12.38824698,11,10,21,52,73,11,2,1,76,576,,,Umbria,888908
563,2020-03-14T17:00:00,ITA,10,43.10675841,12.38824698,21,11,32,71,103,30,3,1,107,748,,,Umbria,888908
564,2020-03-15T17:00:00,ITA,10,43.10675841,12.38824698,25,13,38,101,139,36,3,1,143,965,,,Umbria,888908
565,2020-03-16T17:00:00,ITA,10,43.10675841,12.38824698,30,15,45,114,159,20,4,1,164,1093,,,Umbria,888908
566,2020-03-17T17:00:00,ITA,10,43.10675841,12.38824698,36,21,57,135,192,33,4,1,197,1323,,,Umbria,888908
567,2020-03-18T17:00:00,ITA,10,43.10675841,12.38824698,54,21,75,166,241,49,4,2,247,1601,,,Umbria,888908
568,2020-03-19T17:00:00,ITA,10,43.10675841,12.38824698,69,21,90,238,328,87,4,2,334,1954,,,Umbria,888908
569,2020-03-20T17:00:00,ITA,10,43.10675841,12.38824698,75,24,99,285,384,56,4,7,395,2303,,,Umbria,888908
570,2020-03-21T17:00:00,ITA,10,43.10675841,12.38824698,92,29,121,326,447,63,5,10,462,2712,,,Umbria,888908
571,2020-03-22T17:00:00,ITA,10,43.10675841,12.38824698,97,35,132,368,500,53,5,16,521,3135,,,Umbria,888908
572,2020-03-23T17:00:00,ITA,10,43.10675841,12.38824698,106,42,148,408,556,56,5,16,577,3561,,,Umbria,888908
573,2020-03-24T17:00:00,ITA,10,43.10675841,12.38824698,105,43,148,476,624,68,5,19,648,4108,,,Umbria,888908
574,2020-03-25T17:00:00,ITA,10,43.10675841,12.38824698,123,44,167,519,686,62,5,19,710,4707,,,Umbria,888908
575,2020-03-26T17:00:00,ITA,10,43.10675841,12.38824698,144,46,190,580,770,84,12,20,802,5428,,,Umbria,888908
576,2020-03-27T17:00:00,ITA,10,43.10675841,12.38824698,149,46,195,629,824,54,39,21,884,6137,,,Umbria,888908
577,2020-03-28T17:00:00,ITA,10,43.10675841,12.38824698,159,44,203,695,898,74,43,28,969,7028,,,Umbria,888908
578,2020-02-24T18:00:00,ITA,2,45.73750286,7.320149366,0,0,0,0,0,0,0,0,0,7,,,Valle d'Aosta,126883
579,2020-02-25T18:00:00,ITA,2,45.73750286,7.320149366,0,0,0,0,0,0,0,0,0,7,,,Valle d'Aosta,126883
580,2020-02-26T18:00:00,ITA,2,45.73750286,7.320149366,0,0,0,0,0,0,0,0,0,7,,,Valle d'Aosta,126883
581,2020-02-27T18:00:00,ITA,2,45.73750286,7.320149366,0,0,0,0,0,0,0,0,0,9,,,Valle d'Aosta,126883
582,2020-02-28T18:00:00,ITA,2,45.73750286,7.320149366,0,0,0,0,0,0,0,0,0,9,,,Valle d'Aosta,126883
583,2020-02-29T17:00:00,ITA,2,45.73750286,7.320149366,0,0,0,0,0,0,0,0,0,9,,,Valle d'Aosta,126883
584,2020-03-01T17:00:00,ITA,2,45.73750286,7.320149366,0,0,0,0,0,0,0,0,0,10,,,Valle d'Aosta,126883
585,2020-03-02T18:00:00,ITA,2,45.73750286,7.320149366,0,0,0,0,0,0,0,0,0,11,,,Valle d'Aosta,126883
586,2020-03-03T18:00:00,ITA,2,45.73750286,7.320149366,0,0,0,0,0,0,0,0,0,12,,,Valle d'Aosta,126883
587,2020-03-04T17:00:00,ITA,2,45.73750286,7.320149366,0,0,0,0,0,0,0,0,0,15,,,Valle d'Aosta,126883
588,2020-03-05T17:00:00,ITA,2,45.73750286,7.320149366,0,0,0,2,2,2,0,0,2,21,,,Valle d'Aosta,126883
589,2020-03-06T17:00:00,ITA,2,45.73750286,7.320149366,0,0,0,7,7,5,0,0,7,28,,,Valle d'Aosta,126883
590,2020-03-07T18:00:00,ITA,2,45.73750286,7.320149366,1,0,1,7,8,1,0,0,8,32,,,Valle d'Aosta,126883
591,2020-03-08T18:00:00,ITA,2,45.73750286,7.320149366,1,0,1,8,9,1,0,0,9,41,,,Valle d'Aosta,126883
592,2020-03-09T18:00:00,ITA,2,45.73750286,7.320149366,4,0,4,11,15,6,0,0,15,67,,,Valle d'Aosta,126883
593,2020-03-10T18:00:00,ITA,2,45.73750286,7.320149366,2,0,2,15,17,2,0,0,17,89,,,Valle d'Aosta,126883
594,2020-03-11T17:00:00,ITA,2,45.73750286,7.320149366,2,0,2,17,19,2,0,1,20,99,,,Valle d'Aosta,126883
595,2020-03-12T17:00:00,ITA,2,45.73750286,7.320149366,7,0,7,19,26,7,0,1,27,118,,,Valle d'Aosta,126883
596,2020-03-13T17:00:00,ITA,2,45.73750286,7.320149366,6,0,6,21,27,1,0,1,28,189,,,Valle d'Aosta,126883
597,2020-03-14T17:00:00,ITA,2,45.73750286,7.320149366,12,0,12,29,41,14,0,1,42,231,,,Valle d'Aosta,126883
598,2020-03-15T17:00:00,ITA,2,45.73750286,7.320149366,10,3,13,43,56,15,0,1,57,230,,,Valle d'Aosta,126883
599,2020-03-16T17:00:00,ITA,2,45.73750286,7.320149366,28,5,33,70,103,47,0,2,105,287,,,Valle d'Aosta,126883
600,2020-03-17T17:00:00,ITA,2,45.73750286,7.320149366,35,6,41,93,134,31,0,2,136,398,,,Valle d'Aosta,126883
601,2020-03-18T17:00:00,ITA,2,45.73750286,7.320149366,41,3,44,118,162,28,0,3,165,486,,,Valle d'Aosta,126883
602,2020-03-19T17:00:00,ITA,2,45.73750286,7.320149366,47,9,56,153,209,47,0,6,215,608,,,Valle d'Aosta,126883
603,2020-03-20T17:00:00,ITA,2,45.73750286,7.320149366,54,9,63,194,257,48,0,7,264,814,,,Valle d'Aosta,126883
604,2020-03-21T17:00:00,ITA,2,45.73750286,7.320149366,62,15,77,227,304,47,1,8,313,884,,,Valle d'Aosta,126883
605,2020-03-22T17:00:00,ITA,2,45.73750286,7.320149366,63,21,84,270,354,50,1,9,364,950,,,Valle d'Aosta,126883
606,2020-03-23T17:00:00,ITA,2,45.73750286,7.320149366,69,20,89,290,379,25,2,12,393,1098,,,Valle d'Aosta,126883
607,2020-03-24T17:00:00,ITA,2,45.73750286,7.320149366,71,20,91,288,379,0,2,19,400,1180,,,Valle d'Aosta,126883
608,2020-03-25T17:00:00,ITA,2,45.73750286,7.320149366,70,25,95,280,375,-4,2,24,401,1200,,,Valle d'Aosta,126883
609,2020-03-26T17:00:00,ITA,2,45.73750286,7.320149366,73,24,97,281,378,3,2,28,408,1203,,,Valle d'Aosta,126883
610,2020-03-27T17:00:00,ITA,2,45.73750286,7.320149366,91,24,115,298,413,35,2,37,452,1252,,,Valle d'Aosta,126883
611,2020-03-28T17:00:00,ITA,2,45.73750286,7.320149366,90,26,116,352,468,55,2,41,511,1380,,,Valle d'Aosta,126883
612,2020-02-24T18:00:00,ITA,5,45.43490485,12.33845213,12,4,16,16,32,32,0,1,33,2200,,,Veneto,4907529
613,2020-02-25T18:00:00,ITA,5,45.43490485,12.33845213,12,7,19,23,42,10,0,1,43,3780,,,Veneto,4907529
614,2020-02-26T18:00:00,ITA,5,45.43490485,12.33845213,16,8,24,45,69,27,0,2,71,4900,,,Veneto,4907529
615,2020-02-27T18:00:00,ITA,5,45.43490485,12.33845213,19,8,27,82,109,40,0,2,111,6164,,,Veneto,4907529
616,2020-02-28T18:00:00,ITA,5,45.43490485,12.33845213,24,9,33,116,149,40,0,2,151,7414,,,Veneto,4907529
617,2020-02-29T17:00:00,ITA,5,45.43490485,12.33845213,24,11,35,154,189,40,0,2,191,8659,,,Veneto,4907529
618,2020-03-01T17:00:00,ITA,5,45.43490485,12.33845213,51,13,64,197,261,72,0,2,263,9056,,,Veneto,4907529
619,2020-03-02T18:00:00,ITA,5,45.43490485,12.33845213,53,14,67,204,271,10,0,2,273,9782,,,Veneto,4907529
620,2020-03-03T18:00:00,ITA,5,45.43490485,12.33845213,49,19,68,229,297,26,7,3,307,10176,,,Veneto,4907529
621,2020-03-04T17:00:00,ITA,5,45.43490485,12.33845213,76,23,99,246,345,48,9,6,360,10515,,,Veneto,4907529
622,2020-03-05T17:00:00,ITA,5,45.43490485,12.33845213,92,24,116,264,380,35,17,10,407,11949,,,Veneto,4907529
623,2020-03-06T17:00:00,ITA,5,45.43490485,12.33845213,117,27,144,310,454,74,22,12,488,13023,,,Veneto,4907529
624,2020-03-07T18:00:00,ITA,5,45.43490485,12.33845213,123,41,164,341,505,51,25,13,543,14429,,,Veneto,4907529
625,2020-03-08T18:00:00,ITA,5,45.43490485,12.33845213,146,47,193,430,623,118,29,18,670,15918,,,Veneto,4907529
626,2020-03-09T18:00:00,ITA,5,45.43490485,12.33845213,186,51,237,457,694,71,30,20,744,15956,,,Veneto,4907529
627,2020-03-10T18:00:00,ITA,5,45.43490485,12.33845213,204,67,271,512,783,89,47,26,856,16643,,,Veneto,4907529
628,2020-03-11T17:00:00,ITA,5,45.43490485,12.33845213,262,68,330,610,940,157,54,29,1023,21400,,,Veneto,4907529
629,2020-03-12T17:00:00,ITA,5,45.43490485,12.33845213,360,85,445,852,1297,357,55,32,1384,23438,,,Veneto,4907529
630,2020-03-13T17:00:00,ITA,5,45.43490485,12.33845213,366,107,473,980,1453,156,100,42,1595,25691,,,Veneto,4907529
631,2020-03-14T17:00:00,ITA,5,45.43490485,12.33845213,366,119,485,1290,1775,322,107,55,1937,26980,,,Veneto,4907529
632,2020-03-15T17:00:00,ITA,5,45.43490485,12.33845213,426,129,555,1434,1989,214,120,63,2172,32546,,,Veneto,4907529
633,2020-03-16T17:00:00,ITA,5,45.43490485,12.33845213,498,156,654,1620,2274,285,130,69,2473,35052,,,Veneto,4907529
634,2020-03-17T17:00:00,ITA,5,45.43490485,12.33845213,548,171,719,1769,2488,214,136,80,2704,35478,,,Veneto,4907529
635,2020-03-18T17:00:00,ITA,5,45.43490485,12.33845213,646,195,841,2112,2953,465,167,94,3214,40841,,,Veneto,4907529
636,2020-03-19T17:00:00,ITA,5,45.43490485,12.33845213,771,209,980,2189,3169,216,200,115,3484,44658,,,Veneto,4907529
637,2020-03-20T17:00:00,ITA,5,45.43490485,12.33845213,843,236,1079,2598,3677,508,223,131,4031,49288,,,Veneto,4907529
638,2020-03-21T17:00:00,ITA,5,45.43490485,12.33845213,942,249,1191,3023,4214,537,257,146,4617,53642,,,Veneto,4907529
639,2020-03-22T17:00:00,ITA,5,45.43490485,12.33845213,1113,255,1368,3276,4644,430,309,169,5122,57671,,,Veneto,4907529
640,2020-03-23T17:00:00,ITA,5,45.43490485,12.33845213,1206,281,1487,3499,4986,342,327,192,5505,61115,,,Veneto,4907529
641,2020-03-24T17:00:00,ITA,5,45.43490485,12.33845213,1318,304,1622,3729,5351,365,381,216,5948,66178,,,Veneto,4907529
642,2020-03-25T17:00:00,ITA,5,45.43490485,12.33845213,1407,316,1723,4022,5745,394,439,258,6442,70877,,,Veneto,4907529
643,2020-03-26T17:00:00,ITA,5,45.43490485,12.33845213,1447,326,1773,4367,6140,395,508,287,6935,79759,,,Veneto,4907529
644,2020-03-27T17:00:00,ITA,5,45.43490485,12.33845213,1536,338,1874,4774,6648,508,536,313,7497,83627,,,Veneto,4907529
645,2020-03-28T17:00:00,ITA,5,45.43490485,12.33845213,1559,344,1903,5010,6913,265,655,362,7930,89380,,,Veneto,4907529
