,data,stato,codice_regione,lat,long,ricoverati_con_sintomi,terapia_intensiva,totale_ospedalizzati,isolamento_domiciliare,totale_positivi,variazione_totale_positivi,nuovi_positivi,dimessi_guariti,deceduti,totale_casi,tamponi,casi_testati,regione,abitanti_regione,posti_letto
0,2020-02-24T18:00:00,ITA,13,42.35122196,13.39843823,0,0,0,0,0,0,0,0,0,0,5,,Abruzzo,1322247,151
1,2020-02-25T18:00:00,ITA,13,42.35122196,13.39843823,0,0,0,0,0,0,0,0,0,0,5,,Abruzzo,1322247,151
2,2020-02-26T18:00:00,ITA,13,42.35122196,13.39843823,0,0,0,0,0,0,0,0,0,0,13,,Abruzzo,1322247,151
3,2020-02-27T18:00:00,ITA,13,42.35122196,13.39843823,1,0,1,0,1,1,1,0,0,1,33,,Abruzzo,1322247,151
4,2020-02-28T18:00:00,ITA,13,42.35122196,13.39843823,1,0,1,0,1,0,0,0,0,1,33,,Abruzzo,1322247,151
5,2020-02-29T17:00:00,ITA,13,42.35122196,13.39843823,2,0,2,0,2,1,1,0,0,2,43,,Abruzzo,1322247,151
6,2020-03-01T17:00:00,ITA,13,42.35122196,13.39843823,3,0,3,2,5,3,3,0,0,5,52,,Abruzzo,1322247,151
7,2020-03-02T18:00:00,ITA,13,42.35122196,13.39843823,3,0,3,2,5,0,0,0,0,5,52,,Abruzzo,1322247,151
8,2020-03-03T18:00:00,ITA,13,42.35122196,13.39843823,5,0,5,1,6,1,1,0,0,6,52,,Abruzzo,1322247,151
9,2020-03-04T17:00:00,ITA,13,42.35122196,13.39843823,7,0,7,0,7,1,1,0,0,7,85,,Abruzzo,1322247,151
10,2020-03-05T17:00:00,ITA,13,42.35122196,13.39843823,8,0,8,0,8,1,1,0,0,8,96,,Abruzzo,1322247,151
11,2020-03-06T17:00:00,ITA,13,42.35122196,13.39843823,9,0,9,0,9,1,1,0,0,9,96,,Abruzzo,1322247,151
12,2020-03-07T18:00:00,ITA,13,42.35122196,13.39843823,11,0,11,0,11,2,2,0,0,11,123,,Abruzzo,1322247,151
13,2020-03-08T18:00:00,ITA,13,42.35122196,13.39843823,14,0,14,3,17,6,6,0,0,17,163,,Abruzzo,1322247,151
14,2020-03-09T18:00:00,ITA,13,42.35122196,13.39843823,25,0,25,5,30,13,13,0,0,30,237,,Abruzzo,1322247,151
15,2020-03-10T18:00:00,ITA,13,42.35122196,13.39843823,17,9,26,11,37,7,8,0,1,38,310,,Abruzzo,1322247,151
16,2020-03-11T17:00:00,ITA,13,42.35122196,13.39843823,17,9,26,11,37,0,0,0,1,38,310,,Abruzzo,1322247,151
17,2020-03-12T17:00:00,ITA,13,42.35122196,13.39843823,47,12,59,19,78,41,46,4,2,84,867,,Abruzzo,1322247,151
18,2020-03-13T17:00:00,ITA,13,42.35122196,13.39843823,42,14,56,27,83,5,5,4,2,89,958,,Abruzzo,1322247,151
19,2020-03-14T17:00:00,ITA,13,42.35122196,13.39843823,51,14,65,41,106,23,23,4,2,112,1232,,Abruzzo,1322247,151
20,2020-03-15T17:00:00,ITA,13,42.35122196,13.39843823,72,28,100,28,128,22,25,6,3,137,1419,,Abruzzo,1322247,151
21,2020-03-16T17:00:00,ITA,13,42.35122196,13.39843823,71,37,108,57,165,37,39,7,4,176,1533,,Abruzzo,1322247,151
22,2020-03-17T17:00:00,ITA,13,42.35122196,13.39843823,94,32,126,90,216,51,53,7,6,229,1688,,Abruzzo,1322247,151
23,2020-03-18T17:00:00,ITA,13,42.35122196,13.39843823,99,41,140,109,249,33,34,7,7,263,2054,,Abruzzo,1322247,151
24,2020-03-19T17:00:00,ITA,13,42.35122196,13.39843823,181,47,228,138,366,117,122,8,11,385,2409,,Abruzzo,1322247,151
25,2020-03-20T17:00:00,ITA,13,42.35122196,13.39843823,190,48,238,184,422,56,64,10,17,449,2695,,Abruzzo,1322247,151
26,2020-03-21T17:00:00,ITA,13,42.35122196,13.39843823,185,44,229,265,494,72,80,13,22,529,3035,,Abruzzo,1322247,151
27,2020-03-22T17:00:00,ITA,13,42.35122196,13.39843823,218,49,267,272,539,45,58,15,33,587,3375,,Abruzzo,1322247,151
28,2020-03-23T17:00:00,ITA,13,42.35122196,13.39843823,228,52,280,325,605,66,76,20,38,663,3674,,Abruzzo,1322247,151
29,2020-03-24T17:00:00,ITA,13,42.35122196,13.39843823,234,57,291,331,622,17,26,21,46,689,4294,,Abruzzo,1322247,151
30,2020-03-25T17:00:00,ITA,13,42.35122196,13.39843823,248,59,307,431,738,116,124,23,52,813,4982,,Abruzzo,1322247,151
31,2020-03-26T17:00:00,ITA,13,42.35122196,13.39843823,280,64,344,516,860,122,133,23,63,946,5488,,Abruzzo,1322247,151
32,2020-03-27T17:00:00,ITA,13,42.35122196,13.39843823,289,71,360,565,925,65,71,24,68,1017,6109,,Abruzzo,1322247,151
33,2020-03-28T17:00:00,ITA,13,42.35122196,13.39843823,311,70,381,646,1027,102,116,30,76,1133,7003,,Abruzzo,1322247,151
34,2020-03-29T17:00:00,ITA,13,42.35122196,13.39843823,329,68,397,772,1169,142,160,36,88,1293,7730,,Abruzzo,1322247,151
35,2020-03-30T17:00:00,ITA,13,42.35122196,13.39843823,322,69,391,778,1169,0,52,74,102,1345,7948,,Abruzzo,1322247,151
36,2020-03-31T17:00:00,ITA,13,42.35122196,13.39843823,335,73,408,783,1191,22,56,95,115,1401,8758,,Abruzzo,1322247,151
37,2020-04-01T17:00:00,ITA,13,42.35122196,13.39843823,342,71,413,798,1211,20,35,102,123,1436,9610,,Abruzzo,1322247,151
38,2020-04-02T17:00:00,ITA,13,42.35122196,13.39843823,341,75,416,835,1251,40,61,113,133,1497,10647,,Abruzzo,1322247,151
39,2020-04-03T17:00:00,ITA,13,42.35122196,13.39843823,361,76,437,864,1301,50,66,116,146,1563,11890,,Abruzzo,1322247,151
40,2020-04-04T17:00:00,ITA,13,42.35122196,13.39843823,354,71,425,931,1356,55,65,119,153,1628,12837,,Abruzzo,1322247,151
41,2020-04-05T17:00:00,ITA,13,42.35122196,13.39843823,347,67,414,1006,1420,64,75,125,158,1703,13598,,Abruzzo,1322247,151
42,2020-04-06T17:00:00,ITA,13,42.35122196,13.39843823,340,66,406,1019,1425,5,18,127,169,1721,14198,,Abruzzo,1322247,151
43,2020-04-07T17:00:00,ITA,13,42.35122196,13.39843823,337,67,404,1087,1491,66,78,136,172,1799,14904,,Abruzzo,1322247,151
44,2020-04-08T17:00:00,ITA,13,42.35122196,13.39843823,331,62,393,1141,1534,43,60,146,179,1859,15846,,Abruzzo,1322247,151
45,2020-04-09T17:00:00,ITA,13,42.35122196,13.39843823,306,57,363,1203,1566,32,72,171,194,1931,16847,,Abruzzo,1322247,151
46,2020-04-10T17:00:00,ITA,13,42.35122196,13.39843823,305,53,358,1277,1635,69,83,181,198,2014,18088,,Abruzzo,1322247,151
47,2020-04-11T17:00:00,ITA,13,42.35122196,13.39843823,315,54,369,1355,1724,89,106,190,206,2120,19441,,Abruzzo,1322247,151
48,2020-04-12T17:00:00,ITA,13,42.35122196,13.39843823,346,54,400,1342,1742,18,40,206,212,2160,20594,,Abruzzo,1322247,151
49,2020-04-13T17:00:00,ITA,13,42.35122196,13.39843823,351,54,405,1373,1778,36,53,211,224,2213,20667,,Abruzzo,1322247,151
50,2020-04-14T17:00:00,ITA,13,42.35122196,13.39843823,345,52,397,1403,1800,22,32,213,232,2245,20935,,Abruzzo,1322247,151
51,2020-04-15T17:00:00,ITA,13,42.35122196,13.39843823,341,44,385,1425,1810,10,29,224,240,2274,22500,,Abruzzo,1322247,151
52,2020-04-16T17:00:00,ITA,13,42.35122196,13.39843823,324,42,366,1484,1850,40,72,253,243,2346,23786,,Abruzzo,1322247,151
53,2020-04-17T17:00:00,ITA,13,42.35122196,13.39843823,319,43,362,1580,1942,92,97,255,246,2443,25436,,Abruzzo,1322247,151
54,2020-04-18T17:00:00,ITA,13,42.35122196,13.39843823,321,41,362,1609,1971,29,44,263,253,2487,27016,,Abruzzo,1322247,151
55,2020-04-19T17:00:00,ITA,13,42.35122196,13.39843823,317,40,357,1630,1987,16,34,276,258,2521,27791,22424.0,Abruzzo,1322247,151
56,2020-04-20T17:00:00,ITA,13,42.35122196,13.39843823,320,38,358,1704,2062,75,91,287,263,2612,27942,22552.0,Abruzzo,1322247,151
57,2020-04-21T17:00:00,ITA,13,42.35122196,13.39843823,318,35,353,1714,2067,5,55,329,271,2667,29906,23901.0,Abruzzo,1322247,151
58,2020-04-22T17:00:00,ITA,13,42.35122196,13.39843823,309,35,344,1764,2108,41,66,349,276,2733,30348,24317.0,Abruzzo,1322247,151
59,2020-04-23T17:00:00,ITA,13,42.35122196,13.39843823,322,31,353,1747,2100,-8,52,405,280,2785,31187,24751.0,Abruzzo,1322247,151
60,2020-04-24T17:00:00,ITA,13,42.35122196,13.39843823,327,28,355,1724,2079,-21,18,438,286,2803,32397,25397.0,Abruzzo,1322247,151
61,2020-02-24T18:00:00,ITA,17,40.63947052,15.80514834,0,0,0,0,0,0,0,0,0,0,0,,Basilicata,570365,64
62,2020-02-25T18:00:00,ITA,17,40.63947052,15.80514834,0,0,0,0,0,0,0,0,0,0,0,,Basilicata,570365,64
63,2020-02-26T18:00:00,ITA,17,40.63947052,15.80514834,0,0,0,0,0,0,0,0,0,0,0,,Basilicata,570365,64
64,2020-02-27T18:00:00,ITA,17,40.63947052,15.80514834,0,0,0,0,0,0,0,0,0,0,0,,Basilicata,570365,64
65,2020-02-28T18:00:00,ITA,17,40.63947052,15.80514834,0,0,0,0,0,0,0,0,0,0,0,,Basilicata,570365,64
66,2020-02-29T17:00:00,ITA,17,40.63947052,15.80514834,0,0,0,0,0,0,0,0,0,0,32,,Basilicata,570365,64
67,2020-03-01T17:00:00,ITA,17,40.63947052,15.80514834,0,0,0,0,0,0,0,0,0,0,39,,Basilicata,570365,64
68,2020-03-02T18:00:00,ITA,17,40.63947052,15.80514834,0,0,0,0,0,0,0,0,0,0,39,,Basilicata,570365,64
69,2020-03-03T18:00:00,ITA,17,40.63947052,15.80514834,0,0,0,1,1,1,1,0,0,1,42,,Basilicata,570365,64
70,2020-03-04T17:00:00,ITA,17,40.63947052,15.80514834,0,0,0,1,1,0,0,0,0,1,48,,Basilicata,570365,64
71,2020-03-05T17:00:00,ITA,17,40.63947052,15.80514834,0,0,0,1,1,0,0,0,0,1,54,,Basilicata,570365,64
72,2020-03-06T17:00:00,ITA,17,40.63947052,15.80514834,1,0,1,2,3,2,2,0,0,3,63,,Basilicata,570365,64
73,2020-03-07T18:00:00,ITA,17,40.63947052,15.80514834,1,0,1,2,3,0,0,0,0,3,75,,Basilicata,570365,64
74,2020-03-08T18:00:00,ITA,17,40.63947052,15.80514834,2,0,2,2,4,1,1,0,0,4,123,,Basilicata,570365,64
75,2020-03-09T18:00:00,ITA,17,40.63947052,15.80514834,2,0,2,3,5,1,1,0,0,5,135,,Basilicata,570365,64
76,2020-03-10T18:00:00,ITA,17,40.63947052,15.80514834,2,0,2,5,7,2,2,0,0,7,148,,Basilicata,570365,64
77,2020-03-11T17:00:00,ITA,17,40.63947052,15.80514834,1,1,2,6,8,1,1,0,0,8,155,,Basilicata,570365,64
78,2020-03-12T17:00:00,ITA,17,40.63947052,15.80514834,1,1,2,6,8,0,0,0,0,8,155,,Basilicata,570365,64
79,2020-03-13T17:00:00,ITA,17,40.63947052,15.80514834,1,1,2,8,10,2,2,0,0,10,155,,Basilicata,570365,64
80,2020-03-14T17:00:00,ITA,17,40.63947052,15.80514834,0,2,2,8,10,0,0,0,0,10,155,,Basilicata,570365,64
81,2020-03-15T17:00:00,ITA,17,40.63947052,15.80514834,0,2,2,9,11,1,1,0,0,11,208,,Basilicata,570365,64
82,2020-03-16T17:00:00,ITA,17,40.63947052,15.80514834,1,2,3,9,12,1,1,0,0,12,230,,Basilicata,570365,64
83,2020-03-17T17:00:00,ITA,17,40.63947052,15.80514834,5,2,7,13,20,8,8,0,0,20,262,,Basilicata,570365,64
84,2020-03-18T17:00:00,ITA,17,40.63947052,15.80514834,9,2,11,16,27,7,7,0,0,27,262,,Basilicata,570365,64
85,2020-03-19T17:00:00,ITA,17,40.63947052,15.80514834,8,5,13,24,37,10,10,0,0,37,353,,Basilicata,570365,64
86,2020-03-20T17:00:00,ITA,17,40.63947052,15.80514834,8,5,13,39,52,15,15,0,0,52,443,,Basilicata,570365,64
87,2020-03-21T17:00:00,ITA,17,40.63947052,15.80514834,12,7,19,47,66,14,14,0,0,66,522,,Basilicata,570365,64
88,2020-03-22T17:00:00,ITA,17,40.63947052,15.80514834,13,10,23,58,81,15,15,0,0,81,643,,Basilicata,570365,64
89,2020-03-23T17:00:00,ITA,17,40.63947052,15.80514834,15,12,27,62,89,8,9,0,1,90,696,,Basilicata,570365,64
90,2020-03-24T17:00:00,ITA,17,40.63947052,15.80514834,14,12,26,65,91,2,2,0,1,92,744,,Basilicata,570365,64
91,2020-03-25T17:00:00,ITA,17,40.63947052,15.80514834,20,14,34,78,112,21,21,0,1,113,857,,Basilicata,570365,64
92,2020-03-26T17:00:00,ITA,17,40.63947052,15.80514834,22,16,38,95,133,21,21,0,1,134,1046,,Basilicata,570365,64
93,2020-03-27T17:00:00,ITA,17,40.63947052,15.80514834,22,15,37,110,147,14,17,1,3,151,1254,,Basilicata,570365,64
94,2020-03-28T17:00:00,ITA,17,40.63947052,15.80514834,26,19,45,133,178,31,31,1,3,182,1421,,Basilicata,570365,64
95,2020-03-29T17:00:00,ITA,17,40.63947052,15.80514834,32,18,50,147,197,19,20,1,4,202,1585,,Basilicata,570365,64
96,2020-03-30T17:00:00,ITA,17,40.63947052,15.80514834,36,18,54,154,208,11,12,1,5,214,1833,,Basilicata,570365,64
97,2020-03-31T17:00:00,ITA,17,40.63947052,15.80514834,37,17,54,162,216,8,12,3,7,226,2043,,Basilicata,570365,64
98,2020-04-01T17:00:00,ITA,17,40.63947052,15.80514834,39,15,54,171,225,9,11,3,9,237,2262,,Basilicata,570365,64
99,2020-04-02T17:00:00,ITA,17,40.63947052,15.80514834,38,19,57,176,233,8,9,3,10,246,2427,,Basilicata,570365,64
100,2020-04-03T17:00:00,ITA,17,40.63947052,15.80514834,41,19,60,187,247,14,15,3,11,261,2622,,Basilicata,570365,64
101,2020-04-04T17:00:00,ITA,17,40.63947052,15.80514834,44,19,63,181,244,-3,3,9,11,264,2765,,Basilicata,570365,64
102,2020-04-05T17:00:00,ITA,17,40.63947052,15.80514834,46,18,64,190,254,10,14,11,13,278,2931,,Basilicata,570365,64
103,2020-04-06T17:00:00,ITA,17,40.63947052,15.80514834,46,18,64,198,262,8,9,12,13,287,3061,,Basilicata,570365,64
104,2020-04-07T17:00:00,ITA,17,40.63947052,15.80514834,47,17,64,201,265,3,4,12,14,291,3160,,Basilicata,570365,64
105,2020-04-08T17:00:00,ITA,17,40.63947052,15.80514834,48,17,65,205,270,5,6,13,14,297,3296,,Basilicata,570365,64
106,2020-04-09T17:00:00,ITA,17,40.63947052,15.80514834,50,17,67,208,275,5,6,13,15,303,3474,,Basilicata,570365,64
107,2020-04-10T17:00:00,ITA,17,40.63947052,15.80514834,59,15,74,205,279,4,5,14,15,308,3696,,Basilicata,570365,64
108,2020-04-11T17:00:00,ITA,17,40.63947052,15.80514834,60,12,72,209,281,2,4,14,17,312,4050,,Basilicata,570365,64
109,2020-04-12T17:00:00,ITA,17,40.63947052,15.80514834,61,12,73,204,277,-4,3,20,18,315,4355,,Basilicata,570365,64
110,2020-04-13T17:00:00,ITA,17,40.63947052,15.80514834,64,12,76,194,270,-7,4,31,18,319,4545,,Basilicata,570365,64
111,2020-04-14T17:00:00,ITA,17,40.63947052,15.80514834,62,12,74,191,265,-5,0,35,19,319,4759,,Basilicata,570365,64
112,2020-04-15T17:00:00,ITA,17,40.63947052,15.80514834,60,12,72,189,261,-4,1,38,21,320,5037,,Basilicata,570365,64
113,2020-04-16T17:00:00,ITA,17,40.63947052,15.80514834,60,9,69,204,273,12,16,41,22,336,5349,,Basilicata,570365,64
114,2020-04-17T17:00:00,ITA,17,40.63947052,15.80514834,59,9,68,198,266,-7,1,49,22,337,5710,,Basilicata,570365,64
115,2020-04-18T17:00:00,ITA,17,40.63947052,15.80514834,60,8,68,194,262,-4,2,54,23,339,6056,,Basilicata,570365,64
116,2020-04-19T17:00:00,ITA,17,40.63947052,15.80514834,59,8,67,180,247,-15,3,71,24,342,6528,6528.0,Basilicata,570365,64
117,2020-04-20T17:00:00,ITA,17,40.63947052,15.80514834,59,7,66,176,242,-5,0,76,24,342,6868,6868.0,Basilicata,570365,64
118,2020-04-21T17:00:00,ITA,17,40.63947052,15.80514834,64,7,71,174,245,3,8,81,24,350,7470,7470.0,Basilicata,570365,64
119,2020-04-22T17:00:00,ITA,17,40.63947052,15.80514834,65,7,72,160,232,-13,4,98,24,354,8040,8040.0,Basilicata,570365,64
120,2020-04-23T17:00:00,ITA,17,40.63947052,15.80514834,61,7,68,161,229,-3,2,103,24,356,8511,8511.0,Basilicata,570365,64
121,2020-04-24T17:00:00,ITA,17,40.63947052,15.80514834,59,7,66,163,229,0,4,107,24,360,9026,9026.0,Basilicata,570365,64
122,2020-02-24T18:00:00,ITA,18,38.90597598,16.59440194,0,0,0,0,0,0,0,0,0,0,1,,Calabria,1965128,221
123,2020-02-25T18:00:00,ITA,18,38.90597598,16.59440194,0,0,0,0,0,0,0,0,0,0,2,,Calabria,1965128,221
124,2020-02-26T18:00:00,ITA,18,38.90597598,16.59440194,0,0,0,0,0,0,0,0,0,0,3,,Calabria,1965128,221
125,2020-02-27T18:00:00,ITA,18,38.90597598,16.59440194,0,0,0,0,0,0,0,0,0,0,14,,Calabria,1965128,221
126,2020-02-28T18:00:00,ITA,18,38.90597598,16.59440194,0,0,0,1,1,1,1,0,0,1,21,,Calabria,1965128,221
127,2020-02-29T17:00:00,ITA,18,38.90597598,16.59440194,0,0,0,1,1,0,0,0,0,1,27,,Calabria,1965128,221
128,2020-03-01T17:00:00,ITA,18,38.90597598,16.59440194,0,0,0,1,1,0,0,0,0,1,35,,Calabria,1965128,221
129,2020-03-02T18:00:00,ITA,18,38.90597598,16.59440194,0,0,0,1,1,0,0,0,0,1,39,,Calabria,1965128,221
130,2020-03-03T18:00:00,ITA,18,38.90597598,16.59440194,0,0,0,1,1,0,0,0,0,1,39,,Calabria,1965128,221
131,2020-03-04T17:00:00,ITA,18,38.90597598,16.59440194,0,0,0,1,1,0,0,0,0,1,46,,Calabria,1965128,221
132,2020-03-05T17:00:00,ITA,18,38.90597598,16.59440194,1,0,1,1,2,1,1,0,0,2,53,,Calabria,1965128,221
133,2020-03-06T17:00:00,ITA,18,38.90597598,16.59440194,2,0,2,2,4,2,2,0,0,4,99,,Calabria,1965128,221
134,2020-03-07T18:00:00,ITA,18,38.90597598,16.59440194,2,0,2,2,4,0,0,0,0,4,113,,Calabria,1965128,221
135,2020-03-08T18:00:00,ITA,18,38.90597598,16.59440194,5,0,5,4,9,5,5,0,0,9,113,,Calabria,1965128,221
136,2020-03-09T18:00:00,ITA,18,38.90597598,16.59440194,8,0,8,1,9,0,2,2,0,11,173,,Calabria,1965128,221
137,2020-03-10T18:00:00,ITA,18,38.90597598,16.59440194,8,2,10,1,11,2,2,2,0,13,360,,Calabria,1965128,221
138,2020-03-11T17:00:00,ITA,18,38.90597598,16.59440194,10,2,12,5,17,6,6,2,0,19,405,,Calabria,1965128,221
139,2020-03-12T17:00:00,ITA,18,38.90597598,16.59440194,14,2,16,16,32,15,14,1,0,33,483,,Calabria,1965128,221
140,2020-03-13T17:00:00,ITA,18,38.90597598,16.59440194,18,3,21,16,37,5,5,1,0,38,504,,Calabria,1965128,221
141,2020-03-14T17:00:00,ITA,18,38.90597598,16.59440194,22,4,26,33,59,22,22,1,0,60,711,,Calabria,1965128,221
142,2020-03-15T17:00:00,ITA,18,38.90597598,16.59440194,32,6,38,28,66,7,8,1,1,68,884,,Calabria,1965128,221
143,2020-03-16T17:00:00,ITA,18,38.90597598,16.59440194,36,7,43,44,87,21,21,1,1,89,1030,,Calabria,1965128,221
144,2020-03-17T17:00:00,ITA,18,38.90597598,16.59440194,45,10,55,57,112,25,25,1,1,114,1293,,Calabria,1965128,221
145,2020-03-18T17:00:00,ITA,18,38.90597598,16.59440194,45,11,56,70,126,14,15,2,1,129,1668,,Calabria,1965128,221
146,2020-03-19T17:00:00,ITA,18,38.90597598,16.59440194,60,13,73,91,164,38,40,2,3,169,2342,,Calabria,1965128,221
147,2020-03-20T17:00:00,ITA,18,38.90597598,16.59440194,71,16,87,114,201,37,38,2,4,207,2690,,Calabria,1965128,221
148,2020-03-21T17:00:00,ITA,18,38.90597598,16.59440194,73,16,89,136,225,24,28,5,5,235,3050,,Calabria,1965128,221
149,2020-03-22T17:00:00,ITA,18,38.90597598,16.59440194,77,17,94,166,260,35,38,5,8,273,3666,,Calabria,1965128,221
150,2020-03-23T17:00:00,ITA,18,38.90597598,16.59440194,82,20,102,178,280,20,19,5,7,292,4073,,Calabria,1965128,221
151,2020-03-24T17:00:00,ITA,18,38.90597598,16.59440194,88,21,109,195,304,24,27,5,10,319,4486,,Calabria,1965128,221
152,2020-03-25T17:00:00,ITA,18,38.90597598,16.59440194,93,23,116,217,333,29,32,7,11,351,5058,,Calabria,1965128,221
153,2020-03-26T17:00:00,ITA,18,38.90597598,16.59440194,101,23,124,248,372,39,42,7,14,393,5933,,Calabria,1965128,221
154,2020-03-27T17:00:00,ITA,18,38.90597598,16.59440194,103,22,125,344,469,97,101,7,18,494,6901,,Calabria,1965128,221
155,2020-03-28T17:00:00,ITA,18,38.90597598,16.59440194,107,22,129,394,523,54,61,11,21,555,7760,,Calabria,1965128,221
156,2020-03-29T17:00:00,ITA,18,38.90597598,16.59440194,124,19,143,434,577,54,59,12,25,614,8485,,Calabria,1965128,221
157,2020-03-30T17:00:00,ITA,18,38.90597598,16.59440194,130,18,148,454,602,25,33,14,31,647,9013,,Calabria,1965128,221
158,2020-03-31T17:00:00,ITA,18,38.90597598,16.59440194,132,17,149,457,606,4,12,17,36,659,9327,,Calabria,1965128,221
159,2020-04-01T17:00:00,ITA,18,38.90597598,16.59440194,144,16,160,450,610,4,10,21,38,669,9983,,Calabria,1965128,221
160,2020-04-02T17:00:00,ITA,18,38.90597598,16.59440194,163,19,182,445,627,17,22,23,41,691,10679,,Calabria,1965128,221
161,2020-04-03T17:00:00,ITA,18,38.90597598,16.59440194,183,17,200,462,662,35,42,26,45,733,11608,,Calabria,1965128,221
162,2020-04-04T17:00:00,ITA,18,38.90597598,16.59440194,178,15,193,469,662,0,8,30,49,741,12314,,Calabria,1965128,221
163,2020-04-05T17:00:00,ITA,18,38.90597598,16.59440194,174,13,187,519,706,44,54,33,56,795,13077,,Calabria,1965128,221
164,2020-04-06T17:00:00,ITA,18,38.90597598,16.59440194,170,14,184,538,722,16,22,37,58,817,13633,,Calabria,1965128,221
165,2020-04-07T17:00:00,ITA,18,38.90597598,16.59440194,169,14,183,550,733,11,16,40,60,833,14072,,Calabria,1965128,221
166,2020-04-08T17:00:00,ITA,18,38.90597598,16.59440194,170,15,185,570,755,22,26,44,60,859,14977,,Calabria,1965128,221
167,2020-04-09T17:00:00,ITA,18,38.90597598,16.59440194,168,15,183,582,765,10,15,48,61,874,15698,,Calabria,1965128,221
168,2020-04-10T17:00:00,ITA,18,38.90597598,16.59440194,168,14,182,604,786,21,27,50,65,901,16637,,Calabria,1965128,221
169,2020-04-11T17:00:00,ITA,18,38.90597598,16.59440194,169,15,184,608,792,6,14,57,66,915,17493,,Calabria,1965128,221
170,2020-04-12T17:00:00,ITA,18,38.90597598,16.59440194,165,14,179,616,795,3,8,62,66,923,18211,,Calabria,1965128,221
171,2020-04-13T17:00:00,ITA,18,38.90597598,16.59440194,160,12,172,619,791,-4,5,70,67,928,18596,,Calabria,1965128,221
172,2020-04-14T17:00:00,ITA,18,38.90597598,16.59440194,161,12,173,643,816,25,28,72,68,956,19014,,Calabria,1965128,221
173,2020-04-15T17:00:00,ITA,18,38.90597598,16.59440194,156,11,167,652,819,3,15,81,71,971,19662,,Calabria,1965128,221
174,2020-04-16T17:00:00,ITA,18,38.90597598,16.59440194,157,9,166,681,847,28,38,90,72,1009,20642,,Calabria,1965128,221
175,2020-04-17T17:00:00,ITA,18,38.90597598,16.59440194,154,7,161,658,819,-28,-18,99,73,991,21657,,Calabria,1965128,221
176,2020-04-18T17:00:00,ITA,18,38.90597598,16.59440194,152,7,159,673,832,13,20,106,73,1011,22794,,Calabria,1965128,221
177,2020-04-19T17:00:00,ITA,18,38.90597598,16.59440194,142,6,148,696,844,12,24,116,75,1035,23760,22234.0,Calabria,1965128,221
178,2020-04-20T17:00:00,ITA,18,38.90597598,16.59440194,140,7,147,681,828,-16,3,135,75,1038,24373,22847.0,Calabria,1965128,221
179,2020-04-21T17:00:00,ITA,18,38.90597598,16.59440194,133,7,140,679,819,-9,9,152,76,1047,25440,23914.0,Calabria,1965128,221
180,2020-04-22T17:00:00,ITA,18,38.90597598,16.59440194,128,7,135,686,821,2,13,163,76,1060,26560,24878.0,Calabria,1965128,221
181,2020-04-23T17:00:00,ITA,18,38.90597598,16.59440194,129,7,136,687,823,2,9,170,76,1069,27869,26187.0,Calabria,1965128,221
182,2020-04-24T17:00:00,ITA,18,38.90597598,16.59440194,123,7,130,691,821,-2,10,178,80,1079,28764,26811.0,Calabria,1965128,221
183,2020-02-24T18:00:00,ITA,15,40.83956555,14.25084984,0,0,0,0,0,0,0,0,0,0,10,,Campania,5839084,600
184,2020-02-25T18:00:00,ITA,15,40.83956555,14.25084984,0,0,0,0,0,0,0,0,0,0,10,,Campania,5839084,600
185,2020-02-26T18:00:00,ITA,15,40.83956555,14.25084984,0,0,0,0,0,0,0,0,0,0,10,,Campania,5839084,600
186,2020-02-27T18:00:00,ITA,15,40.83956555,14.25084984,2,0,2,1,3,3,3,0,0,3,10,,Campania,5839084,600
187,2020-02-28T18:00:00,ITA,15,40.83956555,14.25084984,2,0,2,2,4,1,1,0,0,4,213,,Campania,5839084,600
188,2020-02-29T17:00:00,ITA,15,40.83956555,14.25084984,3,0,3,10,13,9,9,0,0,13,373,,Campania,5839084,600
189,2020-03-01T17:00:00,ITA,15,40.83956555,14.25084984,4,0,4,13,17,4,4,0,0,17,373,,Campania,5839084,600
190,2020-03-02T18:00:00,ITA,15,40.83956555,14.25084984,4,0,4,13,17,0,0,0,0,17,373,,Campania,5839084,600
191,2020-03-03T18:00:00,ITA,15,40.83956555,14.25084984,11,0,11,19,30,13,13,0,0,30,405,,Campania,5839084,600
192,2020-03-04T17:00:00,ITA,15,40.83956555,14.25084984,11,0,11,20,31,1,1,0,0,31,429,,Campania,5839084,600
193,2020-03-05T17:00:00,ITA,15,40.83956555,14.25084984,12,0,12,33,45,14,14,0,0,45,471,,Campania,5839084,600
194,2020-03-06T17:00:00,ITA,15,40.83956555,14.25084984,12,0,12,45,57,12,12,0,0,57,471,,Campania,5839084,600
195,2020-03-07T18:00:00,ITA,15,40.83956555,14.25084984,16,0,16,45,61,4,4,0,0,61,612,,Campania,5839084,600
196,2020-03-08T18:00:00,ITA,15,40.83956555,14.25084984,30,7,37,63,100,39,40,1,0,101,980,,Campania,5839084,600
197,2020-03-09T18:00:00,ITA,15,40.83956555,14.25084984,42,8,50,69,119,19,19,1,0,120,980,,Campania,5839084,600
198,2020-03-10T18:00:00,ITA,15,40.83956555,14.25084984,33,8,41,85,126,7,7,1,0,127,1141,,Campania,5839084,600
199,2020-03-11T17:00:00,ITA,15,40.83956555,14.25084984,56,11,67,82,149,23,27,4,1,154,1375,,Campania,5839084,600
200,2020-03-12T17:00:00,ITA,15,40.83956555,14.25084984,56,11,67,107,174,25,25,4,1,179,1551,,Campania,5839084,600
201,2020-03-13T17:00:00,ITA,15,40.83956555,14.25084984,60,19,79,134,213,39,41,5,2,220,1671,,Campania,5839084,600
202,2020-03-14T17:00:00,ITA,15,40.83956555,14.25084984,72,17,89,154,243,30,52,23,6,272,1936,,Campania,5839084,600
203,2020-03-15T17:00:00,ITA,15,40.83956555,14.25084984,73,22,95,201,296,53,61,28,9,333,2213,,Campania,5839084,600
204,2020-03-16T17:00:00,ITA,15,40.83956555,14.25084984,103,22,125,238,363,67,67,28,9,400,2517,,Campania,5839084,600
205,2020-03-17T17:00:00,ITA,15,40.83956555,14.25084984,127,24,151,272,423,60,60,28,9,460,2685,,Campania,5839084,600
206,2020-03-18T17:00:00,ITA,15,40.83956555,14.25084984,127,24,151,272,423,0,0,28,9,460,2685,,Campania,5839084,600
207,2020-03-19T17:00:00,ITA,15,40.83956555,14.25084984,213,36,249,356,605,182,192,30,17,652,3544,,Campania,5839084,600
208,2020-03-20T17:00:00,ITA,15,40.83956555,14.25084984,130,41,171,531,702,97,97,30,17,749,3845,,Campania,5839084,600
209,2020-03-21T17:00:00,ITA,15,40.83956555,14.25084984,233,87,320,473,793,91,95,29,22,844,4448,,Campania,5839084,600
210,2020-03-22T17:00:00,ITA,15,40.83956555,14.25084984,243,99,342,524,866,73,92,41,29,936,4943,,Campania,5839084,600
211,2020-03-23T17:00:00,ITA,15,40.83956555,14.25084984,266,110,376,553,929,63,90,48,49,1026,5813,,Campania,5839084,600
212,2020-03-24T17:00:00,ITA,15,40.83956555,14.25084984,345,181,526,466,992,63,75,53,56,1101,6297,,Campania,5839084,600
213,2020-03-25T17:00:00,ITA,15,40.83956555,14.25084984,318,123,441,631,1072,80,98,53,74,1199,6972,,Campania,5839084,600
214,2020-03-26T17:00:00,ITA,15,40.83956555,14.25084984,448,114,562,607,1169,97,111,58,83,1310,8346,,Campania,5839084,600
215,2020-03-27T17:00:00,ITA,15,40.83956555,14.25084984,456,113,569,723,1292,123,144,64,98,1454,9613,,Campania,5839084,600
216,2020-03-28T17:00:00,ITA,15,40.83956555,14.25084984,463,132,595,812,1407,115,138,76,109,1592,10616,,Campania,5839084,600
217,2020-03-29T17:00:00,ITA,15,40.83956555,14.25084984,476,135,611,945,1556,149,167,86,117,1759,11805,,Campania,5839084,600
218,2020-03-30T17:00:00,ITA,15,40.83956555,14.25084984,468,126,594,1145,1739,183,193,88,125,1952,12969,,Campania,5839084,600
219,2020-03-31T17:00:00,ITA,15,40.83956555,14.25084984,501,133,634,1237,1871,132,140,88,133,2092,14403,,Campania,5839084,600
220,2020-04-01T17:00:00,ITA,15,40.83956555,14.25084984,478,129,607,1369,1976,105,139,107,148,2231,15728,,Campania,5839084,600
221,2020-04-02T17:00:00,ITA,15,40.83956555,14.25084984,503,120,623,1517,2140,164,225,149,167,2456,17404,,Campania,5839084,600
222,2020-04-03T17:00:00,ITA,15,40.83956555,14.25084984,532,115,647,1705,2352,212,221,144,181,2677,19237,,Campania,5839084,600
223,2020-04-04T17:00:00,ITA,15,40.83956555,14.25084984,567,114,681,1815,2496,144,151,146,186,2828,21534,,Campania,5839084,600
224,2020-04-05T17:00:00,ITA,15,40.83956555,14.25084984,609,108,717,1904,2621,125,132,150,189,2960,23139,,Campania,5839084,600
225,2020-04-06T17:00:00,ITA,15,40.83956555,14.25084984,610,101,711,1987,2698,77,98,156,204,3058,24526,,Campania,5839084,600
226,2020-04-07T17:00:00,ITA,15,40.83956555,14.25084984,603,103,706,2059,2765,67,90,167,216,3148,25779,,Campania,5839084,600
227,2020-04-08T17:00:00,ITA,15,40.83956555,14.25084984,608,97,705,2154,2859,94,120,188,221,3268,27784,,Campania,5839084,600
228,2020-04-09T17:00:00,ITA,15,40.83956555,14.25084984,604,94,698,2175,2873,14,76,244,227,3344,29664,,Campania,5839084,600
229,2020-04-10T17:00:00,ITA,15,40.83956555,14.25084984,600,90,690,2273,2963,90,98,248,231,3442,31745,,Campania,5839084,600
230,2020-04-11T17:00:00,ITA,15,40.83956555,14.25084984,582,85,667,2335,3002,39,75,277,238,3517,33781,,Campania,5839084,600
231,2020-04-12T17:00:00,ITA,15,40.83956555,14.25084984,526,82,608,2449,3057,55,87,305,242,3604,35448,,Campania,5839084,600
232,2020-04-13T17:00:00,ITA,15,40.83956555,14.25084984,606,80,686,2376,3062,5,66,360,248,3670,36770,,Campania,5839084,600
233,2020-04-14T17:00:00,ITA,15,40.83956555,14.25084984,618,82,700,2394,3094,32,99,415,260,3769,38094,,Campania,5839084,600
234,2020-04-15T17:00:00,ITA,15,40.83956555,14.25084984,607,86,693,2394,3087,-7,38,442,278,3807,39534,,Campania,5839084,600
235,2020-04-16T17:00:00,ITA,15,40.83956555,14.25084984,618,76,694,2424,3118,31,80,483,286,3887,41296,,Campania,5839084,600
236,2020-04-17T17:00:00,ITA,15,40.83956555,14.25084984,622,76,698,2329,3027,-91,64,631,293,3951,43697,,Campania,5839084,600
237,2020-04-18T17:00:00,ITA,15,40.83956555,14.25084984,605,76,681,2364,3045,18,37,643,300,3988,46294,,Campania,5839084,600
238,2020-04-19T17:00:00,ITA,15,40.83956555,14.25084984,590,61,651,2371,3022,-23,41,703,304,4029,48187,34994.0,Campania,5839084,600
239,2020-04-20T17:00:00,ITA,15,40.83956555,14.25084984,586,61,647,2372,3019,-3,45,746,309,4074,51090,36153.0,Campania,5839084,600
240,2020-04-21T17:00:00,ITA,15,40.83956555,14.25084984,532,58,590,2356,2946,-73,61,872,317,4135,53548,37505.0,Campania,5839084,600
241,2020-04-22T17:00:00,ITA,15,40.83956555,14.25084984,523,53,576,2422,2998,52,50,860,327,4185,55701,38679.0,Campania,5839084,600
242,2020-04-23T17:00:00,ITA,15,40.83956555,14.25084984,539,47,586,2392,2978,-20,53,928,332,4238,58324,38679.0,Campania,5839084,600
243,2020-04-24T17:00:00,ITA,15,40.83956555,14.25084984,524,44,568,2375,2943,-35,44,1003,336,4282,61331,40053.0,Campania,5839084,600
244,2020-02-24T18:00:00,ITA,8,44.49436681,11.341720800000001,10,2,12,6,18,0,18,0,0,18,148,,Emilia-Romagna,4448841,962
245,2020-02-25T18:00:00,ITA,8,44.49436681,11.341720800000001,15,2,17,9,26,8,8,0,0,26,391,,Emilia-Romagna,4448841,962
246,2020-02-26T18:00:00,ITA,8,44.49436681,11.341720800000001,20,3,23,23,46,20,21,0,1,47,577,,Emilia-Romagna,4448841,962
247,2020-02-27T18:00:00,ITA,8,44.49436681,11.341720800000001,36,6,42,54,96,50,50,0,1,97,1033,,Emilia-Romagna,4448841,962
248,2020-02-28T18:00:00,ITA,8,44.49436681,11.341720800000001,56,6,62,81,143,47,48,0,2,145,1277,,Emilia-Romagna,4448841,962
249,2020-02-29T17:00:00,ITA,8,44.49436681,11.341720800000001,86,11,97,116,213,70,72,0,4,217,1550,,Emilia-Romagna,4448841,962
250,2020-03-01T17:00:00,ITA,8,44.49436681,11.341720800000001,127,13,140,137,277,64,68,0,8,285,1795,,Emilia-Romagna,4448841,962
251,2020-03-02T18:00:00,ITA,8,44.49436681,11.341720800000001,148,16,164,160,324,47,50,0,11,335,1973,,Emilia-Romagna,4448841,962
252,2020-03-03T18:00:00,ITA,8,44.49436681,11.341720800000001,187,24,211,187,398,74,85,4,18,420,2012,,Emilia-Romagna,4448841,962
253,2020-03-04T17:00:00,ITA,8,44.49436681,11.341720800000001,256,26,282,234,516,118,124,6,22,544,2500,,Emilia-Romagna,4448841,962
254,2020-03-05T17:00:00,ITA,8,44.49436681,11.341720800000001,327,32,359,299,658,142,154,10,30,698,2884,,Emilia-Romagna,4448841,962
255,2020-03-06T17:00:00,ITA,8,44.49436681,11.341720800000001,397,53,450,366,816,158,172,17,37,870,3136,,Emilia-Romagna,4448841,962
256,2020-03-07T18:00:00,ITA,8,44.49436681,11.341720800000001,464,64,528,409,937,121,140,25,48,1010,3604,,Emilia-Romagna,4448841,962
257,2020-03-08T18:00:00,ITA,8,44.49436681,11.341720800000001,542,75,617,480,1097,160,170,27,56,1180,4344,,Emilia-Romagna,4448841,962
258,2020-03-09T18:00:00,ITA,8,44.49436681,11.341720800000001,576,90,666,620,1286,189,206,30,70,1386,4906,,Emilia-Romagna,4448841,962
259,2020-03-10T18:00:00,ITA,8,44.49436681,11.341720800000001,669,98,767,650,1417,131,147,31,85,1533,5494,,Emilia-Romagna,4448841,962
260,2020-03-11T17:00:00,ITA,8,44.49436681,11.341720800000001,745,104,849,739,1588,171,206,38,113,1739,6640,,Emilia-Romagna,4448841,962
261,2020-03-12T17:00:00,ITA,8,44.49436681,11.341720800000001,814,112,926,832,1758,170,208,43,146,1947,7600,,Emilia-Romagna,4448841,962
262,2020-03-13T17:00:00,ITA,8,44.49436681,11.341720800000001,942,128,1070,941,2011,253,316,51,201,2263,8787,,Emilia-Romagna,4448841,962
263,2020-03-14T17:00:00,ITA,8,44.49436681,11.341720800000001,1076,152,1228,1121,2349,338,381,54,241,2644,10043,,Emilia-Romagna,4448841,962
264,2020-03-15T17:00:00,ITA,8,44.49436681,11.341720800000001,1215,169,1384,1357,2741,392,449,68,284,3093,12054,,Emilia-Romagna,4448841,962
265,2020-03-16T17:00:00,ITA,8,44.49436681,11.341720800000001,1362,197,1559,1529,3088,347,429,88,346,3522,13096,,Emilia-Romagna,4448841,962
266,2020-03-17T17:00:00,ITA,8,44.49436681,11.341720800000001,1566,223,1789,1615,3404,316,409,134,393,3931,14510,,Emilia-Romagna,4448841,962
267,2020-03-18T17:00:00,ITA,8,44.49436681,11.341720800000001,1784,247,2031,1884,3915,511,594,152,458,4525,15461,,Emilia-Romagna,4448841,962
268,2020-03-19T17:00:00,ITA,8,44.49436681,11.341720800000001,1900,260,2160,2346,4506,591,689,177,531,5214,18344,,Emilia-Romagna,4448841,962
269,2020-03-20T17:00:00,ITA,8,44.49436681,11.341720800000001,2083,267,2350,2739,5089,583,754,239,640,5968,20753,,Emilia-Romagna,4448841,962
270,2020-03-21T17:00:00,ITA,8,44.49436681,11.341720800000001,2267,265,2532,3129,5661,572,737,329,715,6705,24620,,Emilia-Romagna,4448841,962
271,2020-03-22T17:00:00,ITA,8,44.49436681,11.341720800000001,2429,269,2698,3692,6390,729,850,349,816,7555,28022,,Emilia-Romagna,4448841,962
272,2020-03-23T17:00:00,ITA,8,44.49436681,11.341720800000001,2846,276,3122,4098,7220,830,980,423,892,8535,31200,,Emilia-Romagna,4448841,962
273,2020-03-24T17:00:00,ITA,8,44.49436681,11.341720800000001,2974,291,3265,4446,7711,491,719,558,985,9254,33527,,Emilia-Romagna,4448841,962
274,2020-03-25T17:00:00,ITA,8,44.49436681,11.341720800000001,3180,294,3474,4782,8256,545,800,721,1077,10054,38045,,Emilia-Romagna,4448841,962
275,2020-03-26T17:00:00,ITA,8,44.49436681,11.341720800000001,3354,301,3655,5195,8850,594,762,792,1174,10816,42395,,Emilia-Romagna,4448841,962
276,2020-03-27T17:00:00,ITA,8,44.49436681,11.341720800000001,3461,308,3769,5592,9361,511,772,960,1267,11588,47798,,Emilia-Romagna,4448841,962
277,2020-03-28T17:00:00,ITA,8,44.49436681,11.341720800000001,3695,316,4011,5953,9964,603,795,1075,1344,12383,52991,,Emilia-Romagna,4448841,962
278,2020-03-29T17:00:00,ITA,8,44.49436681,11.341720800000001,3769,333,4102,6433,10535,571,736,1141,1443,13119,52991,,Emilia-Romagna,4448841,962
279,2020-03-30T17:00:00,ITA,8,44.49436681,11.341720800000001,3779,351,4130,6636,10766,231,412,1227,1538,13531,50990,,Emilia-Romagna,4448841,962
280,2020-03-31T17:00:00,ITA,8,44.49436681,11.341720800000001,3765,353,4118,6835,10953,187,543,1477,1644,14074,54532,,Emilia-Romagna,4448841,962
281,2020-04-01T17:00:00,ITA,8,44.49436681,11.341720800000001,3898,359,4257,7232,11489,536,713,1566,1732,14787,58457,,Emilia-Romagna,4448841,962
282,2020-04-02T17:00:00,ITA,8,44.49436681,11.341720800000001,3944,366,4310,7549,11859,370,546,1663,1811,15333,60507,,Emilia-Romagna,4448841,962
283,2020-04-03T17:00:00,ITA,8,44.49436681,11.341720800000001,3915,364,4279,7899,12178,319,599,1852,1902,15932,63682,,Emilia-Romagna,4448841,962
284,2020-04-04T17:00:00,ITA,8,44.49436681,11.341720800000001,3859,358,4217,8306,12523,345,608,2040,1977,16540,67075,,Emilia-Romagna,4448841,962
285,2020-04-05T17:00:00,ITA,8,44.49436681,11.341720800000001,3839,375,4214,8623,12837,314,549,2201,2051,17089,69986,,Emilia-Romagna,4448841,962
286,2020-04-06T17:00:00,ITA,8,44.49436681,11.341720800000001,3804,372,4176,8875,13051,214,467,2397,2108,17556,72163,,Emilia-Romagna,4448841,962
287,2020-04-07T17:00:00,ITA,8,44.49436681,11.341720800000001,3750,366,4116,8932,13048,-3,269,2597,2180,17825,75191,,Emilia-Romagna,4448841,962
288,2020-04-08T17:00:00,ITA,8,44.49436681,11.341720800000001,3769,361,4130,8980,13110,62,409,2890,2234,18234,78367,,Emilia-Romagna,4448841,962
289,2020-04-09T17:00:00,ITA,8,44.49436681,11.341720800000001,3722,355,4077,9181,13258,148,443,3103,2316,18677,81715,,Emilia-Romagna,4448841,962
290,2020-04-10T17:00:00,ITA,8,44.49436681,11.341720800000001,3596,349,3945,9405,13350,92,451,3381,2397,19128,85884,,Emilia-Romagna,4448841,962
291,2020-04-11T17:00:00,ITA,8,44.49436681,11.341720800000001,3530,341,3871,9624,13495,145,507,3659,2481,19635,91759,,Emilia-Romagna,4448841,962
292,2020-04-12T17:00:00,ITA,8,44.49436681,11.341720800000001,3491,335,3826,9846,13672,177,463,3862,2564,20098,96704,,Emilia-Romagna,4448841,962
293,2020-04-13T17:00:00,ITA,8,44.49436681,11.341720800000001,3490,331,3821,9997,13818,146,342,4007,2615,20440,99047,,Emilia-Romagna,4448841,962
294,2020-04-14T17:00:00,ITA,8,44.49436681,11.341720800000001,3473,328,3801,9977,13778,-40,312,4269,2705,20752,101896,,Emilia-Romagna,4448841,962
295,2020-04-15T17:00:00,ITA,8,44.49436681,11.341720800000001,3388,325,3713,9864,13577,-201,277,4664,2788,21029,106149,,Emilia-Romagna,4448841,962
296,2020-04-16T17:00:00,ITA,8,44.49436681,11.341720800000001,3360,316,3676,9987,13663,86,457,4980,2843,21486,112105,,Emilia-Romagna,4448841,962
297,2020-04-17T17:00:00,ITA,8,44.49436681,11.341720800000001,3330,309,3639,9946,13585,-78,348,5346,2903,21834,116826,,Emilia-Romagna,4448841,962
298,2020-04-18T17:00:00,ITA,8,44.49436681,11.341720800000001,3234,296,3530,10054,13584,-1,350,5635,2965,22184,121220,,Emilia-Romagna,4448841,962
299,2020-04-19T17:00:00,ITA,8,44.49436681,11.341720800000001,3166,289,3455,10097,13552,-32,376,5985,3023,22560,124916,88776.0,Emilia-Romagna,4448841,962
300,2020-04-20T17:00:00,ITA,8,44.49436681,11.341720800000001,3144,283,3427,10095,13522,-30,307,6266,3079,22867,129530,90894.0,Emilia-Romagna,4448841,962
301,2020-04-21T17:00:00,ITA,8,44.49436681,11.341720800000001,3045,282,3327,9917,13244,-278,225,6701,3147,23092,134878,93367.0,Emilia-Romagna,4448841,962
302,2020-04-22T17:00:00,ITA,8,44.49436681,11.341720800000001,2964,282,3246,9838,13084,-160,342,7146,3204,23434,140874,96824.0,Emilia-Romagna,4448841,962
303,2020-04-23T17:00:00,ITA,8,44.49436681,11.341720800000001,2889,266,3155,9690,12845,-239,289,7609,3269,23723,146146,99714.0,Emilia-Romagna,4448841,962
304,2020-04-24T17:00:00,ITA,8,44.49436681,11.341720800000001,2807,264,3071,9438,12509,-336,247,8158,3303,23970,151505,102495.0,Emilia-Romagna,4448841,962
305,2020-02-24T18:00:00,ITA,6,45.6494354,13.76813649,0,0,0,0,0,0,0,0,0,0,58,,Friuli Venezia Giulia,1217872,155
306,2020-02-25T18:00:00,ITA,6,45.6494354,13.76813649,0,0,0,0,0,0,0,0,0,0,89,,Friuli Venezia Giulia,1217872,155
307,2020-02-26T18:00:00,ITA,6,45.6494354,13.76813649,0,0,0,0,0,0,0,0,0,0,114,,Friuli Venezia Giulia,1217872,155
308,2020-02-27T18:00:00,ITA,6,45.6494354,13.76813649,0,0,0,0,0,0,0,0,0,0,141,,Friuli Venezia Giulia,1217872,155
309,2020-02-28T18:00:00,ITA,6,45.6494354,13.76813649,0,0,0,0,0,0,0,0,0,0,169,,Friuli Venezia Giulia,1217872,155
310,2020-02-29T17:00:00,ITA,6,45.6494354,13.76813649,0,0,0,0,0,0,0,0,0,0,189,,Friuli Venezia Giulia,1217872,155
311,2020-03-01T17:00:00,ITA,6,45.6494354,13.76813649,0,0,0,6,6,6,6,0,0,6,243,,Friuli Venezia Giulia,1217872,155
312,2020-03-02T18:00:00,ITA,6,45.6494354,13.76813649,0,0,0,9,9,3,3,0,0,9,269,,Friuli Venezia Giulia,1217872,155
313,2020-03-03T18:00:00,ITA,6,45.6494354,13.76813649,1,0,1,12,13,4,4,0,0,13,354,,Friuli Venezia Giulia,1217872,155
314,2020-03-04T17:00:00,ITA,6,45.6494354,13.76813649,3,0,3,15,18,5,5,0,0,18,376,,Friuli Venezia Giulia,1217872,155
315,2020-03-05T17:00:00,ITA,6,45.6494354,13.76813649,4,0,4,17,21,3,3,0,0,21,397,,Friuli Venezia Giulia,1217872,155
316,2020-03-06T17:00:00,ITA,6,45.6494354,13.76813649,4,0,4,24,28,7,10,3,0,31,577,,Friuli Venezia Giulia,1217872,155
317,2020-03-07T18:00:00,ITA,6,45.6494354,13.76813649,7,1,8,31,39,11,11,3,0,42,577,,Friuli Venezia Giulia,1217872,155
318,2020-03-08T18:00:00,ITA,6,45.6494354,13.76813649,7,1,8,45,53,14,15,3,1,57,997,,Friuli Venezia Giulia,1217872,155
319,2020-03-09T18:00:00,ITA,6,45.6494354,13.76813649,18,1,19,70,89,36,36,3,1,93,1344,,Friuli Venezia Giulia,1217872,155
320,2020-03-10T18:00:00,ITA,6,45.6494354,13.76813649,27,6,33,77,110,21,23,3,3,116,1602,,Friuli Venezia Giulia,1217872,155
321,2020-03-11T17:00:00,ITA,6,45.6494354,13.76813649,16,5,21,89,110,0,10,10,6,126,2073,,Friuli Venezia Giulia,1217872,155
322,2020-03-12T17:00:00,ITA,6,45.6494354,13.76813649,23,10,33,115,148,38,41,11,8,167,2604,,Friuli Venezia Giulia,1217872,155
323,2020-03-13T17:00:00,ITA,6,45.6494354,13.76813649,59,8,67,169,236,88,90,11,10,257,3149,,Friuli Venezia Giulia,1217872,155
324,2020-03-14T17:00:00,ITA,6,45.6494354,13.76813649,67,11,78,193,271,35,44,17,13,301,3376,,Friuli Venezia Giulia,1217872,155
325,2020-03-15T17:00:00,ITA,6,45.6494354,13.76813649,98,12,110,206,316,45,46,17,14,347,3407,,Friuli Venezia Giulia,1217872,155
326,2020-03-16T17:00:00,ITA,6,45.6494354,13.76813649,96,19,115,231,346,30,39,18,22,386,4851,,Friuli Venezia Giulia,1217872,155
327,2020-03-17T17:00:00,ITA,6,45.6494354,13.76813649,104,21,125,222,347,1,8,17,30,394,4958,,Friuli Venezia Giulia,1217872,155
328,2020-03-18T17:00:00,ITA,6,45.6494354,13.76813649,128,27,155,261,416,69,68,15,31,462,4958,,Friuli Venezia Giulia,1217872,155
329,2020-03-19T17:00:00,ITA,6,45.6494354,13.76813649,134,29,163,359,522,106,137,41,36,599,4052,,Friuli Venezia Giulia,1217872,155
330,2020-03-20T17:00:00,ITA,6,45.6494354,13.76813649,143,32,175,380,555,33,57,63,38,656,4964,,Friuli Venezia Giulia,1217872,155
331,2020-03-21T17:00:00,ITA,6,45.6494354,13.76813649,152,37,189,477,666,111,134,82,42,790,5955,,Friuli Venezia Giulia,1217872,155
332,2020-03-22T17:00:00,ITA,6,45.6494354,13.76813649,163,47,210,528,738,72,84,89,47,874,6761,,Friuli Venezia Giulia,1217872,155
333,2020-03-23T17:00:00,ITA,6,45.6494354,13.76813649,185,41,226,545,771,33,56,105,54,930,7424,,Friuli Venezia Giulia,1217872,155
334,2020-03-24T17:00:00,ITA,6,45.6494354,13.76813649,195,49,244,604,848,77,62,80,64,992,8526,,Friuli Venezia Giulia,1217872,155
335,2020-03-25T17:00:00,ITA,6,45.6494354,13.76813649,200,52,252,659,911,63,147,158,70,1139,9494,,Friuli Venezia Giulia,1217872,155
336,2020-03-26T17:00:00,ITA,6,45.6494354,13.76813649,212,54,266,688,954,43,84,197,72,1223,10721,,Friuli Venezia Giulia,1217872,155
337,2020-03-27T17:00:00,ITA,6,45.6494354,13.76813649,222,57,279,748,1027,73,94,214,76,1317,11841,,Friuli Venezia Giulia,1217872,155
338,2020-03-28T17:00:00,ITA,6,45.6494354,13.76813649,223,59,282,838,1120,93,119,229,87,1436,12723,,Friuli Venezia Giulia,1217872,155
339,2020-03-29T17:00:00,ITA,6,45.6494354,13.76813649,236,60,296,845,1141,21,44,241,98,1480,13397,,Friuli Venezia Giulia,1217872,155
340,2020-03-30T17:00:00,ITA,6,45.6494354,13.76813649,229,60,289,820,1109,-32,21,285,107,1501,14003,,Friuli Venezia Giulia,1217872,155
341,2020-03-31T17:00:00,ITA,6,45.6494354,13.76813649,215,60,275,885,1160,51,92,320,113,1593,14899,,Friuli Venezia Giulia,1217872,155
342,2020-04-01T17:00:00,ITA,6,45.6494354,13.76813649,206,60,266,940,1206,46,92,357,122,1685,15987,,Friuli Venezia Giulia,1217872,155
343,2020-04-02T17:00:00,ITA,6,45.6494354,13.76813649,199,60,259,1035,1294,88,114,376,129,1799,17121,,Friuli Venezia Giulia,1217872,155
344,2020-04-03T17:00:00,ITA,6,45.6494354,13.76813649,201,61,262,1062,1324,30,80,419,136,1879,19985,,Friuli Venezia Giulia,1217872,155
345,2020-04-04T17:00:00,ITA,6,45.6494354,13.76813649,183,50,233,1103,1336,12,107,505,145,1986,21126,,Friuli Venezia Giulia,1217872,155
346,2020-04-05T17:00:00,ITA,6,45.6494354,13.76813649,185,50,235,1128,1363,27,62,531,154,2048,21652,,Friuli Venezia Giulia,1217872,155
347,2020-04-06T17:00:00,ITA,6,45.6494354,13.76813649,189,46,235,1161,1396,33,55,549,158,2103,22272,,Friuli Venezia Giulia,1217872,155
348,2020-04-07T17:00:00,ITA,6,45.6494354,13.76813649,185,44,229,1150,1379,-17,50,610,164,2153,23536,,Friuli Venezia Giulia,1217872,155
349,2020-04-08T17:00:00,ITA,6,45.6494354,13.76813649,162,41,203,1212,1415,36,65,634,169,2218,24798,,Friuli Venezia Giulia,1217872,155
350,2020-04-09T17:00:00,ITA,6,45.6494354,13.76813649,167,37,204,1186,1390,-25,81,738,171,2299,26205,,Friuli Venezia Giulia,1217872,155
351,2020-04-10T17:00:00,ITA,6,45.6494354,13.76813649,167,33,200,1198,1398,8,50,772,179,2349,28097,,Friuli Venezia Giulia,1217872,155
352,2020-04-11T17:00:00,ITA,6,45.6494354,13.76813649,172,28,200,1182,1382,-16,44,826,185,2393,29685,,Friuli Venezia Giulia,1217872,155
353,2020-04-12T17:00:00,ITA,6,45.6494354,13.76813649,160,28,188,1138,1326,-56,38,910,195,2431,29988,,Friuli Venezia Giulia,1217872,155
354,2020-04-13T17:00:00,ITA,6,45.6494354,13.76813649,159,30,189,1118,1307,-19,51,973,202,2482,30941,,Friuli Venezia Giulia,1217872,155
355,2020-04-14T17:00:00,ITA,6,45.6494354,13.76813649,166,28,194,705,899,-408,38,1415,206,2520,31764,,Friuli Venezia Giulia,1217872,155
356,2020-04-15T17:00:00,ITA,6,45.6494354,13.76813649,163,24,187,1207,1394,495,24,938,212,2544,33800,,Friuli Venezia Giulia,1217872,155
357,2020-04-16T17:00:00,ITA,6,45.6494354,13.76813649,159,26,185,1145,1330,-64,72,1069,217,2616,35766,,Friuli Venezia Giulia,1217872,155
358,2020-04-17T17:00:00,ITA,6,45.6494354,13.76813649,148,23,171,1257,1428,98,59,1027,220,2675,40030,,Friuli Venezia Giulia,1217872,155
359,2020-04-18T17:00:00,ITA,6,45.6494354,13.76813649,141,27,168,1235,1403,-25,56,1106,222,2731,43293,,Friuli Venezia Giulia,1217872,155
360,2020-04-19T17:00:00,ITA,6,45.6494354,13.76813649,140,25,165,1172,1337,-66,14,1183,225,2745,44622,27544.0,Friuli Venezia Giulia,1217872,155
361,2020-04-20T17:00:00,ITA,6,45.6494354,13.76813649,140,22,162,1028,1190,-147,30,1346,239,2775,45161,28777.0,Friuli Venezia Giulia,1217872,155
362,2020-04-21T17:00:00,ITA,6,45.6494354,13.76813649,139,21,160,1162,1322,132,17,1229,241,2792,48500,31352.0,Friuli Venezia Giulia,1217872,155
363,2020-04-22T17:00:00,ITA,6,45.6494354,13.76813649,134,20,154,1154,1308,-14,25,1263,246,2817,50869,32871.0,Friuli Venezia Giulia,1217872,155
364,2020-04-23T17:00:00,ITA,6,45.6494354,13.76813649,138,18,156,979,1135,-173,41,1467,256,2858,52918,34057.0,Friuli Venezia Giulia,1217872,155
365,2020-04-24T17:00:00,ITA,6,45.6494354,13.76813649,136,16,152,1168,1320,185,24,1304,258,2882,55502,35547.0,Friuli Venezia Giulia,1217872,155
366,2020-02-24T18:00:00,ITA,12,41.89277044,12.48366722,1,1,2,0,2,0,2,1,0,3,124,,Lazio,5898124,707
367,2020-02-25T18:00:00,ITA,12,41.89277044,12.48366722,1,1,2,0,2,0,0,1,0,3,124,,Lazio,5898124,707
368,2020-02-26T18:00:00,ITA,12,41.89277044,12.48366722,0,0,0,0,0,-2,0,3,0,3,124,,Lazio,5898124,707
369,2020-02-27T18:00:00,ITA,12,41.89277044,12.48366722,0,0,0,0,0,0,0,3,0,3,552,,Lazio,5898124,707
370,2020-02-28T18:00:00,ITA,12,41.89277044,12.48366722,0,0,0,0,0,0,0,3,0,3,611,,Lazio,5898124,707
371,2020-02-29T17:00:00,ITA,12,41.89277044,12.48366722,3,0,3,0,3,3,3,3,0,6,679,,Lazio,5898124,707
372,2020-03-01T17:00:00,ITA,12,41.89277044,12.48366722,3,0,3,0,3,0,0,3,0,6,724,,Lazio,5898124,707
373,2020-03-02T18:00:00,ITA,12,41.89277044,12.48366722,3,0,3,1,4,1,1,3,0,7,773,,Lazio,5898124,707
374,2020-03-03T18:00:00,ITA,12,41.89277044,12.48366722,10,0,10,1,11,7,7,3,0,14,877,,Lazio,5898124,707
375,2020-03-04T17:00:00,ITA,12,41.89277044,12.48366722,15,3,18,9,27,16,16,3,0,30,995,,Lazio,5898124,707
376,2020-03-05T17:00:00,ITA,12,41.89277044,12.48366722,20,7,27,14,41,14,14,3,0,44,1175,,Lazio,5898124,707
377,2020-03-06T17:00:00,ITA,12,41.89277044,12.48366722,26,8,34,16,50,9,10,3,1,54,1373,,Lazio,5898124,707
378,2020-03-07T18:00:00,ITA,12,41.89277044,12.48366722,43,8,51,21,72,22,22,3,1,76,1582,,Lazio,5898124,707
379,2020-03-08T18:00:00,ITA,12,41.89277044,12.48366722,47,8,55,26,81,9,11,3,3,87,1929,,Lazio,5898124,707
380,2020-03-09T18:00:00,ITA,12,41.89277044,12.48366722,55,8,63,31,94,13,15,3,5,102,1929,,Lazio,5898124,707
381,2020-03-10T18:00:00,ITA,12,41.89277044,12.48366722,50,15,65,34,99,5,14,11,6,116,3591,,Lazio,5898124,707
382,2020-03-11T17:00:00,ITA,12,41.89277044,12.48366722,67,18,85,40,125,26,34,19,6,150,3591,,Lazio,5898124,707
383,2020-03-12T17:00:00,ITA,12,41.89277044,12.48366722,85,20,105,67,172,47,50,19,9,200,5592,,Lazio,5898124,707
384,2020-03-13T17:00:00,ITA,12,41.89277044,12.48366722,122,24,146,96,242,70,77,24,11,277,6491,,Lazio,5898124,707
385,2020-03-14T17:00:00,ITA,12,41.89277044,12.48366722,181,25,206,114,320,78,80,24,13,357,7335,,Lazio,5898124,707
386,2020-03-15T17:00:00,ITA,12,41.89277044,12.48366722,223,31,254,142,396,76,79,24,16,436,8345,,Lazio,5898124,707
387,2020-03-16T17:00:00,ITA,12,41.89277044,12.48366722,267,31,298,174,472,76,87,32,19,523,9330,,Lazio,5898124,707
388,2020-03-17T17:00:00,ITA,12,41.89277044,12.48366722,314,44,358,192,550,78,84,34,23,607,9436,,Lazio,5898124,707
389,2020-03-18T17:00:00,ITA,12,41.89277044,12.48366722,374,44,418,232,650,100,117,42,32,724,11145,,Lazio,5898124,707
390,2020-03-19T17:00:00,ITA,12,41.89277044,12.48366722,426,45,471,270,741,91,99,44,38,823,11145,,Lazio,5898124,707
391,2020-03-20T17:00:00,ITA,12,41.89277044,12.48366722,537,47,584,328,912,171,185,53,43,1008,13889,,Lazio,5898124,707
392,2020-03-21T17:00:00,ITA,12,41.89277044,12.48366722,591,70,661,425,1086,174,182,54,50,1190,13889,,Lazio,5898124,707
393,2020-03-22T17:00:00,ITA,12,41.89277044,12.48366722,671,79,750,522,1272,186,193,58,53,1383,17845,,Lazio,5898124,707
394,2020-03-23T17:00:00,ITA,12,41.89277044,12.48366722,718,96,814,600,1414,142,157,63,63,1540,18371,,Lazio,5898124,707
395,2020-03-24T17:00:00,ITA,12,41.89277044,12.48366722,747,94,841,704,1545,131,188,103,80,1728,18371,,Lazio,5898124,707
396,2020-03-25T17:00:00,ITA,12,41.89277044,12.48366722,805,101,906,769,1675,130,173,131,95,1901,20669,,Lazio,5898124,707
397,2020-03-26T17:00:00,ITA,12,41.89277044,12.48366722,878,113,991,844,1835,160,195,155,106,2096,22771,,Lazio,5898124,707
398,2020-03-27T17:00:00,ITA,12,41.89277044,12.48366722,992,126,1118,895,2013,178,199,164,118,2295,24106,,Lazio,5898124,707
399,2020-03-28T17:00:00,ITA,12,41.89277044,12.48366722,985,133,1118,1063,2181,168,210,200,124,2505,27179,,Lazio,5898124,707
400,2020-03-29T17:00:00,ITA,12,41.89277044,12.48366722,1062,133,1195,1167,2362,181,201,208,136,2706,27744,,Lazio,5898124,707
401,2020-03-30T17:00:00,ITA,12,41.89277044,12.48366722,1079,154,1233,1264,2497,135,208,267,150,2914,32846,,Lazio,5898124,707
402,2020-03-31T17:00:00,ITA,12,41.89277044,12.48366722,1127,173,1300,1342,2642,145,181,291,162,3095,34677,,Lazio,5898124,707
403,2020-04-01T17:00:00,ITA,12,41.89277044,12.48366722,1131,177,1308,1450,2758,116,169,337,169,3264,35810,,Lazio,5898124,707
404,2020-04-02T17:00:00,ITA,12,41.89277044,12.48366722,1169,181,1350,1529,2879,121,169,369,185,3433,41575,,Lazio,5898124,707
405,2020-04-03T17:00:00,ITA,12,41.89277044,12.48366722,1194,188,1382,1627,3009,130,167,392,199,3600,43776,,Lazio,5898124,707
406,2020-04-04T17:00:00,ITA,12,41.89277044,12.48366722,1236,193,1429,1677,3106,97,157,439,212,3757,44624,,Lazio,5898124,707
407,2020-04-05T17:00:00,ITA,12,41.89277044,12.48366722,1235,197,1432,1754,3186,80,123,475,219,3880,44658,,Lazio,5898124,707
408,2020-04-06T17:00:00,ITA,12,41.89277044,12.48366722,1235,197,1432,1868,3300,114,151,502,229,4031,47470,,Lazio,5898124,707
409,2020-04-07T17:00:00,ITA,12,41.89277044,12.48366722,1229,192,1421,1944,3365,65,118,546,238,4149,48874,,Lazio,5898124,707
410,2020-04-08T17:00:00,ITA,12,41.89277044,12.48366722,1241,196,1437,2011,3448,83,117,574,244,4266,55113,,Lazio,5898124,707
411,2020-04-09T17:00:00,ITA,12,41.89277044,12.48366722,1244,198,1442,2090,3532,84,163,644,253,4429,58107,,Lazio,5898124,707
412,2020-04-10T17:00:00,ITA,12,41.89277044,12.48366722,1236,201,1437,2196,3633,101,154,687,263,4583,61769,,Lazio,5898124,707
413,2020-04-11T17:00:00,ITA,12,41.89277044,12.48366722,1264,203,1467,2263,3730,97,140,720,273,4723,65241,,Lazio,5898124,707
414,2020-04-12T17:00:00,ITA,12,41.89277044,12.48366722,1268,201,1469,2348,3817,87,122,749,279,4845,68954,,Lazio,5898124,707
415,2020-04-13T17:00:00,ITA,12,41.89277044,12.48366722,1314,200,1514,2406,3920,103,123,764,284,4968,72746,,Lazio,5898124,707
416,2020-04-14T17:00:00,ITA,12,41.89277044,12.48366722,1344,199,1543,2479,4022,102,143,789,300,5111,74650,,Lazio,5898124,707
417,2020-04-15T17:00:00,ITA,12,41.89277044,12.48366722,1342,196,1538,2509,4047,25,121,874,311,5232,75584,,Lazio,5898124,707
418,2020-04-16T17:00:00,ITA,12,41.89277044,12.48366722,1347,197,1544,2600,4144,97,148,920,316,5380,81993,,Lazio,5898124,707
419,2020-04-17T17:00:00,ITA,12,41.89277044,12.48366722,1332,187,1519,2695,4214,70,144,978,332,5524,84755,,Lazio,5898124,707
420,2020-04-18T17:00:00,ITA,12,41.89277044,12.48366722,1376,186,1562,2720,4282,68,144,1046,340,5668,89553,,Lazio,5898124,707
421,2020-04-19T17:00:00,ITA,12,41.89277044,12.48366722,1370,185,1555,2766,4321,39,87,1093,341,5755,91807,22702.0,Lazio,5898124,707
422,2020-04-20T17:00:00,ITA,12,41.89277044,12.48366722,1388,185,1573,2792,4365,44,60,1101,349,5815,97823,23067.0,Lazio,5898124,707
423,2020-04-21T17:00:00,ITA,12,41.89277044,12.48366722,1380,184,1564,2838,4402,37,80,1130,363,5895,100031,24046.0,Lazio,5898124,707
424,2020-04-22T17:00:00,ITA,12,41.89277044,12.48366722,1384,187,1571,2892,4463,61,80,1142,370,5975,104062,25244.0,Lazio,5898124,707
425,2020-04-23T17:00:00,ITA,12,41.89277044,12.48366722,1385,186,1571,2915,4486,23,79,1193,375,6054,111073,26298.0,Lazio,5898124,707
426,2020-04-24T17:00:00,ITA,12,41.89277044,12.48366722,1396,184,1580,2912,4492,6,78,1256,384,6132,114317,86545.0,Lazio,5898124,707
427,2020-02-24T18:00:00,ITA,7,44.41149315,8.9326992,0,0,0,0,0,0,0,0,0,0,1,,Liguria,1565307,251
428,2020-02-25T18:00:00,ITA,7,44.41149315,8.9326992,1,0,1,0,1,1,1,0,0,1,39,,Liguria,1565307,251
429,2020-02-26T18:00:00,ITA,7,44.41149315,8.9326992,6,0,6,5,11,10,10,0,0,11,66,,Liguria,1565307,251
430,2020-02-27T18:00:00,ITA,7,44.41149315,8.9326992,9,0,9,10,19,8,8,0,0,19,78,,Liguria,1565307,251
431,2020-02-28T18:00:00,ITA,7,44.41149315,8.9326992,9,0,9,10,19,0,0,0,0,19,112,,Liguria,1565307,251
432,2020-02-29T17:00:00,ITA,7,44.41149315,8.9326992,4,1,5,33,38,19,23,4,0,42,121,,Liguria,1565307,251
433,2020-03-01T17:00:00,ITA,7,44.41149315,8.9326992,12,1,13,8,21,-17,-17,4,0,25,121,,Liguria,1565307,251
434,2020-03-02T18:00:00,ITA,7,44.41149315,8.9326992,12,1,13,5,18,-3,-3,4,0,22,121,,Liguria,1565307,251
435,2020-03-03T18:00:00,ITA,7,44.41149315,8.9326992,12,2,14,5,19,1,2,4,1,24,121,,Liguria,1565307,251
436,2020-03-04T17:00:00,ITA,7,44.41149315,8.9326992,10,3,13,8,21,2,2,4,1,26,133,,Liguria,1565307,251
437,2020-03-05T17:00:00,ITA,7,44.41149315,8.9326992,11,3,14,7,21,0,2,4,3,28,146,,Liguria,1565307,251
438,2020-03-06T17:00:00,ITA,7,44.41149315,8.9326992,12,5,17,7,24,3,4,5,3,32,229,,Liguria,1565307,251
439,2020-03-07T18:00:00,ITA,7,44.41149315,8.9326992,26,6,32,10,42,18,19,5,4,51,331,,Liguria,1565307,251
440,2020-03-08T18:00:00,ITA,7,44.41149315,8.9326992,39,11,50,17,67,25,27,5,6,78,401,,Liguria,1565307,251
441,2020-03-09T18:00:00,ITA,7,44.41149315,8.9326992,60,17,77,20,97,30,31,5,7,109,611,,Liguria,1565307,251
442,2020-03-10T18:00:00,ITA,7,44.41149315,8.9326992,57,29,86,42,128,31,32,5,8,141,694,,Liguria,1565307,251
443,2020-03-11T17:00:00,ITA,7,44.41149315,8.9326992,74,34,108,73,181,53,53,5,8,194,1025,,Liguria,1565307,251
444,2020-03-12T17:00:00,ITA,7,44.41149315,8.9326992,100,36,136,107,243,62,80,20,11,274,1174,,Liguria,1565307,251
445,2020-03-13T17:00:00,ITA,7,44.41149315,8.9326992,128,44,172,132,304,61,71,24,17,345,1442,,Liguria,1565307,251
446,2020-03-14T17:00:00,ITA,7,44.41149315,8.9326992,213,62,275,109,384,80,118,52,27,463,1750,,Liguria,1565307,251
447,2020-03-15T17:00:00,ITA,7,44.41149315,8.9326992,253,66,319,174,493,109,96,33,33,559,1973,,Liguria,1565307,251
448,2020-03-16T17:00:00,ITA,7,44.41149315,8.9326992,255,73,328,247,575,82,108,42,50,667,2189,,Liguria,1565307,251
449,2020-03-17T17:00:00,ITA,7,44.41149315,8.9326992,299,85,384,277,661,86,111,57,60,778,2509,,Liguria,1565307,251
450,2020-03-18T17:00:00,ITA,7,44.41149315,8.9326992,401,100,501,243,744,83,109,70,73,887,2912,,Liguria,1565307,251
451,2020-03-19T17:00:00,ITA,7,44.41149315,8.9326992,491,112,603,280,883,139,172,85,91,1059,3348,,Liguria,1565307,251
452,2020-03-20T17:00:00,ITA,7,44.41149315,8.9326992,573,121,694,307,1001,118,162,101,119,1221,3794,,Liguria,1565307,251
453,2020-03-21T17:00:00,ITA,7,44.41149315,8.9326992,598,129,727,432,1159,158,215,125,152,1436,4304,,Liguria,1565307,251
454,2020-03-22T17:00:00,ITA,7,44.41149315,8.9326992,736,132,868,483,1351,192,229,143,171,1665,4995,,Liguria,1565307,251
455,2020-03-23T17:00:00,ITA,7,44.41149315,8.9326992,761,133,894,659,1553,202,259,159,212,1924,5538,,Liguria,1565307,251
456,2020-03-24T17:00:00,ITA,7,44.41149315,8.9326992,803,147,950,742,1692,139,192,193,231,2116,5992,,Liguria,1565307,251
457,2020-03-25T17:00:00,ITA,7,44.41149315,8.9326992,927,147,1074,752,1826,134,189,225,254,2305,6602,,Liguria,1565307,251
458,2020-03-26T17:00:00,ITA,7,44.41149315,8.9326992,998,154,1152,875,2027,201,262,260,280,2567,7304,,Liguria,1565307,251
459,2020-03-27T17:00:00,ITA,7,44.41149315,8.9326992,1023,157,1180,880,2060,33,129,305,331,2696,7804,,Liguria,1565307,251
460,2020-03-28T17:00:00,ITA,7,44.41149315,8.9326992,1031,167,1198,888,2086,26,126,378,358,2822,8177,,Liguria,1565307,251
461,2020-03-29T17:00:00,ITA,7,44.41149315,8.9326992,1077,166,1243,1036,2279,193,254,420,377,3076,9100,,Liguria,1565307,251
462,2020-03-30T17:00:00,ITA,7,44.41149315,8.9326992,1142,175,1317,1066,2383,104,141,437,397,3217,9677,,Liguria,1565307,251
463,2020-03-31T17:00:00,ITA,7,44.41149315,8.9326992,1153,179,1332,1176,2508,125,199,480,428,3416,10376,,Liguria,1565307,251
464,2020-04-01T17:00:00,ITA,7,44.41149315,8.9326992,1114,179,1293,1352,2645,137,244,555,460,3660,11334,,Liguria,1565307,251
465,2020-04-02T17:00:00,ITA,7,44.41149315,8.9326992,1120,172,1292,1368,2660,15,122,634,488,3782,12069,,Liguria,1565307,251
466,2020-04-03T17:00:00,ITA,7,44.41149315,8.9326992,1147,173,1320,1426,2746,86,183,700,519,3965,12934,,Liguria,1565307,251
467,2020-04-04T17:00:00,ITA,7,44.41149315,8.9326992,1121,169,1290,1604,2894,148,238,767,542,4203,14087,,Liguria,1565307,251
468,2020-04-05T17:00:00,ITA,7,44.41149315,8.9326992,1126,165,1291,1802,3093,199,246,800,556,4449,15047,,Liguria,1565307,251
469,2020-04-06T17:00:00,ITA,7,44.41149315,8.9326992,1141,162,1303,1814,3117,24,100,837,595,4549,15533,,Liguria,1565307,251
470,2020-04-07T17:00:00,ITA,7,44.41149315,8.9326992,1090,156,1246,1966,3212,95,208,925,620,4757,16579,,Liguria,1565307,251
471,2020-04-08T17:00:00,ITA,7,44.41149315,8.9326992,1109,153,1262,1983,3245,33,149,1007,654,4906,17521,,Liguria,1565307,251
472,2020-04-09T17:00:00,ITA,7,44.41149315,8.9326992,1103,154,1257,1996,3253,8,114,1085,682,5020,18446,,Liguria,1565307,251
473,2020-04-10T17:00:00,ITA,7,44.41149315,8.9326992,1076,151,1227,2074,3301,48,171,1181,709,5191,19514,,Liguria,1565307,251
474,2020-04-11T17:00:00,ITA,7,44.41149315,8.9326992,1003,146,1149,2184,3333,32,185,1309,734,5376,20888,,Liguria,1565307,251
475,2020-04-12T17:00:00,ITA,7,44.41149315,8.9326992,1032,144,1176,2157,3333,0,118,1412,749,5494,21983,,Liguria,1565307,251
476,2020-04-13T17:00:00,ITA,7,44.41149315,8.9326992,1088,138,1226,2139,3365,32,102,1471,760,5596,23129,,Liguria,1565307,251
477,2020-04-14T17:00:00,ITA,7,44.41149315,8.9326992,967,133,1100,2366,3466,101,212,1549,793,5808,24446,,Liguria,1565307,251
478,2020-04-15T17:00:00,ITA,7,44.41149315,8.9326992,959,120,1079,2385,3464,-2,128,1665,807,5936,25793,,Liguria,1565307,251
479,2020-04-16T17:00:00,ITA,7,44.41149315,8.9326992,957,103,1060,2377,3437,-27,103,1774,828,6039,26945,,Liguria,1565307,251
480,2020-04-17T17:00:00,ITA,7,44.41149315,8.9326992,897,105,1002,2457,3459,22,149,1863,866,6188,28181,,Liguria,1565307,251
481,2020-04-18T17:00:00,ITA,7,44.41149315,8.9326992,901,105,1006,2406,3412,-47,113,1992,897,6301,29322,,Liguria,1565307,251
482,2020-04-19T17:00:00,ITA,7,44.41149315,8.9326992,885,101,986,2504,3490,78,227,2110,928,6528,31551,21103.0,Liguria,1565307,251
483,2020-04-20T17:00:00,ITA,7,44.41149315,8.9326992,878,102,980,2516,3496,6,141,2216,957,6669,33007,21979.0,Liguria,1565307,251
484,2020-04-21T17:00:00,ITA,7,44.41149315,8.9326992,914,94,1008,2455,3463,-33,95,2311,990,6764,34186,22670.0,Liguria,1565307,251
485,2020-04-22T17:00:00,ITA,7,44.41149315,8.9326992,860,92,952,2524,3476,13,154,2420,1022,6918,35990,23756.0,Liguria,1565307,251
486,2020-04-23T17:00:00,ITA,7,44.41149315,8.9326992,783,91,874,2592,3466,-10,131,2536,1047,7049,37842,25045.0,Liguria,1565307,251
487,2020-04-24T17:00:00,ITA,7,44.41149315,8.9326992,760,87,847,2590,3437,-29,124,2660,1076,7173,39563,26040.0,Liguria,1565307,251
488,2020-02-24T18:00:00,ITA,3,45.46679409,9.190347404,76,19,95,71,166,0,166,0,6,172,1463,,Lombardia,10018806,1260
489,2020-02-25T18:00:00,ITA,3,45.46679409,9.190347404,79,25,104,127,231,65,68,0,9,240,3700,,Lombardia,10018806,1260
490,2020-02-26T18:00:00,ITA,3,45.46679409,9.190347404,79,25,104,145,249,18,18,0,9,258,3208,,Lombardia,10018806,1260
491,2020-02-27T18:00:00,ITA,3,45.46679409,9.190347404,172,41,213,136,349,100,145,40,14,403,3320,,Lombardia,10018806,1260
492,2020-02-28T18:00:00,ITA,3,45.46679409,9.190347404,235,47,282,192,474,125,128,40,17,531,4835,,Lombardia,10018806,1260
493,2020-02-29T17:00:00,ITA,3,45.46679409,9.190347404,256,80,336,216,552,78,84,40,23,615,5723,,Lombardia,10018806,1260
494,2020-03-01T17:00:00,ITA,3,45.46679409,9.190347404,406,106,512,375,887,335,369,73,24,984,6879,,Lombardia,10018806,1260
495,2020-03-02T18:00:00,ITA,3,45.46679409,9.190347404,478,127,605,472,1077,190,270,139,38,1254,7925,,Lombardia,10018806,1260
496,2020-03-03T18:00:00,ITA,3,45.46679409,9.190347404,698,167,865,461,1326,249,266,139,55,1520,9577,,Lombardia,10018806,1260
497,2020-03-04T17:00:00,ITA,3,45.46679409,9.190347404,877,209,1086,411,1497,171,300,250,73,1820,12138,,Lombardia,10018806,1260
498,2020-03-05T17:00:00,ITA,3,45.46679409,9.190347404,1169,244,1413,364,1777,280,431,376,98,2251,12354,,Lombardia,10018806,1260
499,2020-03-06T17:00:00,ITA,3,45.46679409,9.190347404,1622,309,1931,77,2008,231,361,469,135,2612,13556,,Lombardia,10018806,1260
500,2020-03-07T18:00:00,ITA,3,45.46679409,9.190347404,1661,359,2020,722,2742,734,808,524,154,3420,15778,,Lombardia,10018806,1260
501,2020-03-08T18:00:00,ITA,3,45.46679409,9.190347404,2217,399,2616,756,3372,630,769,550,267,4189,18534,,Lombardia,10018806,1260
502,2020-03-09T18:00:00,ITA,3,45.46679409,9.190347404,2802,440,3242,1248,4490,1118,1280,646,333,5469,20135,,Lombardia,10018806,1260
503,2020-03-10T18:00:00,ITA,3,45.46679409,9.190347404,3319,466,3785,642,4427,-63,322,896,468,5791,21479,,Lombardia,10018806,1260
504,2020-03-11T17:00:00,ITA,3,45.46679409,9.190347404,3852,560,4412,1351,5763,1336,1489,900,617,7280,25629,,Lombardia,10018806,1260
505,2020-03-12T17:00:00,ITA,3,45.46679409,9.190347404,4247,605,4852,2044,6896,1133,1445,1085,744,8725,29534,,Lombardia,10018806,1260
506,2020-03-13T17:00:00,ITA,3,45.46679409,9.190347404,4435,650,5085,2647,7732,836,1095,1198,890,9820,32700,,Lombardia,10018806,1260
507,2020-03-14T17:00:00,ITA,3,45.46679409,9.190347404,4898,732,5630,3429,9059,1327,1865,1660,966,11685,37138,,Lombardia,10018806,1260
508,2020-03-15T17:00:00,ITA,3,45.46679409,9.190347404,5500,767,6267,3776,10043,984,1587,2011,1218,13272,40369,,Lombardia,10018806,1260
509,2020-03-16T17:00:00,ITA,3,45.46679409,9.190347404,6171,823,6994,3867,10861,818,1377,2368,1420,14649,43565,,Lombardia,10018806,1260
510,2020-03-17T17:00:00,ITA,3,45.46679409,9.190347404,6953,879,7832,4263,12095,1234,1571,2485,1640,16220,46449,,Lombardia,10018806,1260
511,2020-03-18T17:00:00,ITA,3,45.46679409,9.190347404,7285,924,8209,4057,12266,171,1493,3488,1959,17713,48983,,Lombardia,10018806,1260
512,2020-03-19T17:00:00,ITA,3,45.46679409,9.190347404,7387,1006,8393,5545,13938,1672,2171,3778,2168,19884,52244,,Lombardia,10018806,1260
513,2020-03-20T17:00:00,ITA,3,45.46679409,9.190347404,7735,1050,8785,6635,15420,1482,2380,4295,2549,22264,57174,,Lombardia,10018806,1260
514,2020-03-21T17:00:00,ITA,3,45.46679409,9.190347404,8258,1093,9351,8019,17370,1950,3251,5050,3095,25515,66730,,Lombardia,10018806,1260
515,2020-03-22T17:00:00,ITA,3,45.46679409,9.190347404,9439,1142,10581,7304,17885,515,1691,5865,3456,27206,70598,,Lombardia,10018806,1260
516,2020-03-23T17:00:00,ITA,3,45.46679409,9.190347404,9266,1183,10449,8461,18910,1025,1555,6075,3776,28761,73242,,Lombardia,10018806,1260
517,2020-03-24T17:00:00,ITA,3,45.46679409,9.190347404,9711,1194,10905,8963,19868,958,1942,6657,4178,30703,76695,,Lombardia,10018806,1260
518,2020-03-25T17:00:00,ITA,3,45.46679409,9.190347404,10026,1236,11262,9329,20591,723,1643,7281,4474,32346,81666,,Lombardia,10018806,1260
519,2020-03-26T17:00:00,ITA,3,45.46679409,9.190347404,10681,1263,11944,10245,22189,1598,2543,7839,4861,34889,87713,,Lombardia,10018806,1260
520,2020-03-27T17:00:00,ITA,3,45.46679409,9.190347404,11137,1292,12429,11466,23895,1706,2409,8001,5402,37298,95860,,Lombardia,10018806,1260
521,2020-03-28T17:00:00,ITA,3,45.46679409,9.190347404,11152,1319,12471,12038,24509,614,2117,8962,5944,39415,102503,,Lombardia,10018806,1260
522,2020-03-29T17:00:00,ITA,3,45.46679409,9.190347404,11613,1328,12941,12451,25392,883,1592,9255,6360,41007,107398,,Lombardia,10018806,1260
523,2020-03-30T17:00:00,ITA,3,45.46679409,9.190347404,11815,1330,13145,11861,25006,-386,1154,10337,6818,42161,111057,,Lombardia,10018806,1260
524,2020-03-31T17:00:00,ITA,3,45.46679409,9.190347404,11883,1324,13207,11917,25124,118,1047,10885,7199,43208,114640,,Lombardia,10018806,1260
525,2020-04-01T17:00:00,ITA,3,45.46679409,9.190347404,11927,1342,13269,12496,25765,641,1565,11415,7593,44773,121449,,Lombardia,10018806,1260
526,2020-04-02T17:00:00,ITA,3,45.46679409,9.190347404,11762,1351,13113,12763,25876,111,1292,12229,7960,46065,128286,,Lombardia,10018806,1260
527,2020-04-03T17:00:00,ITA,3,45.46679409,9.190347404,11802,1381,13183,13006,26189,313,1455,13020,8311,47520,135051,,Lombardia,10018806,1260
528,2020-04-04T17:00:00,ITA,3,45.46679409,9.190347404,12002,1326,13328,13892,27220,1031,1598,13242,8656,49118,141877,,Lombardia,10018806,1260
529,2020-04-05T17:00:00,ITA,3,45.46679409,9.190347404,12009,1317,13326,14798,28124,904,1337,13426,8905,50455,149984,,Lombardia,10018806,1260
530,2020-04-06T17:00:00,ITA,3,45.46679409,9.190347404,11914,1343,13257,15212,28469,345,1079,13863,9202,51534,154989,,Lombardia,10018806,1260
531,2020-04-07T17:00:00,ITA,3,45.46679409,9.190347404,11833,1305,13138,15205,28343,-126,791,14498,9484,52325,159331,,Lombardia,10018806,1260
532,2020-04-08T17:00:00,ITA,3,45.46679409,9.190347404,11719,1257,12976,15569,28545,202,1089,15147,9722,53414,167557,,Lombardia,10018806,1260
533,2020-04-09T17:00:00,ITA,3,45.46679409,9.190347404,11796,1236,13032,16042,29074,529,1388,15706,10022,54802,176953,,Lombardia,10018806,1260
534,2020-04-10T17:00:00,ITA,3,45.46679409,9.190347404,11877,1202,13079,16451,29530,456,1246,16280,10238,56048,186325,,Lombardia,10018806,1260
535,2020-04-11T17:00:00,ITA,3,45.46679409,9.190347404,12026,1174,13200,17058,30258,728,1544,16823,10511,57592,196302,,Lombardia,10018806,1260
536,2020-04-12T17:00:00,ITA,3,45.46679409,9.190347404,11969,1176,13145,18120,31265,1007,1460,17166,10621,59052,205832,,Lombardia,10018806,1260
537,2020-04-13T17:00:00,ITA,3,45.46679409,9.190347404,12028,1143,13171,18764,31935,670,1262,17478,10901,60314,211092,,Lombardia,10018806,1260
538,2020-04-14T17:00:00,ITA,3,45.46679409,9.190347404,12077,1122,13199,19164,32363,428,1012,17821,11142,61326,214870,,Lombardia,10018806,1260
539,2020-04-15T17:00:00,ITA,3,45.46679409,9.190347404,12043,1074,13117,19804,32921,558,827,17855,11377,62153,221968,,Lombardia,10018806,1260
540,2020-04-16T17:00:00,ITA,3,45.46679409,9.190347404,11356,1032,12388,20702,33090,169,941,18396,11608,63094,232674,,Lombardia,10018806,1260
541,2020-04-17T17:00:00,ITA,3,45.46679409,9.190347404,10627,971,11598,21836,33434,344,1041,18850,11851,64135,243513,,Lombardia,10018806,1260
542,2020-04-18T17:00:00,ITA,3,45.46679409,9.190347404,10042,947,10989,23206,34195,761,1246,19136,12050,65381,255331,,Lombardia,10018806,1260
543,2020-04-19T17:00:00,ITA,3,45.46679409,9.190347404,10342,922,11264,23233,34497,302,855,19526,12213,66236,264155,183757.0,Lombardia,10018806,1260
544,2020-04-20T17:00:00,ITA,3,45.46679409,9.190347404,10138,901,11039,23548,34587,90,735,20008,12376,66971,270486,173333.0,Lombardia,10018806,1260
545,2020-04-21T17:00:00,ITA,3,45.46679409,9.190347404,9805,851,10656,23322,33978,-609,960,21374,12579,67931,277197,173333.0,Lombardia,10018806,1260
546,2020-04-22T17:00:00,ITA,3,45.46679409,9.190347404,9692,817,10509,23733,34242,264,1161,22110,12740,69092,290699,184323.0,Lombardia,10018806,1260
547,2020-04-23T17:00:00,ITA,3,45.46679409,9.190347404,9192,790,9982,23891,33873,-369,1073,23352,12940,70165,302715,190451.0,Lombardia,10018806,1260
548,2020-04-24T17:00:00,ITA,3,45.46679409,9.190347404,8791,756,9547,24821,34368,495,1091,23782,13106,71256,314298,196406.0,Lombardia,10018806,1260
549,2020-02-24T18:00:00,ITA,11,43.61675973,13.5188753,0,0,0,0,0,0,0,0,0,0,16,,Marche,1538055,163
550,2020-02-25T18:00:00,ITA,11,43.61675973,13.5188753,0,0,0,0,0,0,0,0,0,0,21,,Marche,1538055,163
551,2020-02-26T18:00:00,ITA,11,43.61675973,13.5188753,1,0,1,0,1,1,1,0,0,1,28,,Marche,1538055,163
552,2020-02-27T18:00:00,ITA,11,43.61675973,13.5188753,2,1,3,0,3,2,2,0,0,3,46,,Marche,1538055,163
553,2020-02-28T18:00:00,ITA,11,43.61675973,13.5188753,3,2,5,1,6,3,3,0,0,6,47,,Marche,1538055,163
554,2020-02-29T17:00:00,ITA,11,43.61675973,13.5188753,6,2,8,3,11,5,5,0,0,11,68,,Marche,1538055,163
555,2020-03-01T17:00:00,ITA,11,43.61675973,13.5188753,12,5,17,8,25,14,14,0,0,25,101,,Marche,1538055,163
556,2020-03-02T18:00:00,ITA,11,43.61675973,13.5188753,17,6,23,11,34,9,10,0,1,35,137,,Marche,1538055,163
557,2020-03-03T18:00:00,ITA,11,43.61675973,13.5188753,27,13,40,19,59,25,26,0,2,61,200,,Marche,1538055,163
558,2020-03-04T17:00:00,ITA,11,43.61675973,13.5188753,34,15,49,31,80,21,23,0,4,84,288,,Marche,1538055,163
559,2020-03-05T17:00:00,ITA,11,43.61675973,13.5188753,57,19,76,44,120,40,40,0,4,124,413,,Marche,1538055,163
560,2020-03-06T17:00:00,ITA,11,43.61675973,13.5188753,73,20,93,62,155,35,35,0,4,159,585,,Marche,1538055,163
561,2020-03-07T18:00:00,ITA,11,43.61675973,13.5188753,94,36,130,71,201,46,48,0,6,207,816,,Marche,1538055,163
562,2020-03-08T18:00:00,ITA,11,43.61675973,13.5188753,110,41,151,114,265,64,65,0,7,272,1025,,Marche,1538055,163
563,2020-03-09T18:00:00,ITA,11,43.61675973,13.5188753,136,47,183,130,313,48,51,0,10,323,1250,,Marche,1538055,163
564,2020-03-10T18:00:00,ITA,11,43.61675973,13.5188753,152,54,206,175,381,68,71,0,13,394,1437,,Marche,1538055,163
565,2020-03-11T17:00:00,ITA,11,43.61675973,13.5188753,212,66,278,183,461,80,85,0,18,479,1656,,Marche,1538055,163
566,2020-03-12T17:00:00,ITA,11,43.61675973,13.5188753,254,76,330,240,570,109,113,0,22,592,1907,,Marche,1538055,163
567,2020-03-13T17:00:00,ITA,11,43.61675973,13.5188753,337,85,422,276,698,128,133,0,27,725,2218,,Marche,1538055,163
568,2020-03-14T17:00:00,ITA,11,43.61675973,13.5188753,449,93,542,321,863,165,174,0,36,899,2561,,Marche,1538055,163
569,2020-03-15T17:00:00,ITA,11,43.61675973,13.5188753,521,98,619,468,1087,224,234,0,46,1133,2946,,Marche,1538055,163
570,2020-03-16T17:00:00,ITA,11,43.61675973,13.5188753,528,110,638,547,1185,98,109,0,57,1242,3225,,Marche,1538055,163
571,2020-03-17T17:00:00,ITA,11,43.61675973,13.5188753,599,109,708,594,1302,117,129,0,69,1371,3225,,Marche,1538055,163
572,2020-03-18T17:00:00,ITA,11,43.61675973,13.5188753,638,119,757,719,1476,174,197,0,92,1568,4109,,Marche,1538055,163
573,2020-03-19T17:00:00,ITA,11,43.61675973,13.5188753,656,141,797,825,1622,146,169,0,115,1737,4512,,Marche,1538055,163
574,2020-03-20T17:00:00,ITA,11,43.61675973,13.5188753,704,138,842,1002,1844,222,244,0,137,1981,5170,,Marche,1538055,163
575,2020-03-21T17:00:00,ITA,11,43.61675973,13.5188753,742,141,883,1114,1997,153,172,2,154,2153,5740,,Marche,1538055,163
576,2020-03-22T17:00:00,ITA,11,43.61675973,13.5188753,816,138,954,1277,2231,234,268,6,184,2421,6391,,Marche,1538055,163
577,2020-03-23T17:00:00,ITA,11,43.61675973,13.5188753,882,148,1030,1328,2358,127,148,8,203,2569,6782,,Marche,1538055,163
578,2020-03-24T17:00:00,ITA,11,43.61675973,13.5188753,862,149,1011,1486,2497,139,167,8,231,2736,7229,,Marche,1538055,163
579,2020-03-25T17:00:00,ITA,11,43.61675973,13.5188753,938,148,1086,1553,2639,142,198,8,287,2934,7896,,Marche,1538055,163
580,2020-03-26T17:00:00,ITA,11,43.61675973,13.5188753,977,166,1143,1652,2795,156,180,9,310,3114,8623,,Marche,1538055,163
581,2020-03-27T17:00:00,ITA,11,43.61675973,13.5188753,979,162,1141,1709,2850,55,82,10,336,3196,9060,,Marche,1538055,163
582,2020-03-28T17:00:00,ITA,11,43.61675973,13.5188753,987,166,1153,1846,2999,149,177,10,364,3373,9884,,Marche,1538055,163
583,2020-03-29T17:00:00,ITA,11,43.61675973,13.5188753,1000,168,1168,1992,3160,161,185,12,386,3558,10431,,Marche,1538055,163
584,2020-03-30T17:00:00,ITA,11,43.61675973,13.5188753,998,167,1165,2086,3251,91,126,16,417,3684,10979,,Marche,1538055,163
585,2020-03-31T17:00:00,ITA,11,43.61675973,13.5188753,946,169,1115,2237,3352,101,141,21,452,3825,11724,,Marche,1538055,163
586,2020-04-01T17:00:00,ITA,11,43.61675973,13.5188753,984,168,1152,2304,3456,104,137,29,477,3962,12296,,Marche,1538055,163
587,2020-04-02T17:00:00,ITA,11,43.61675973,13.5188753,986,164,1150,2405,3555,99,136,40,503,4098,12943,,Marche,1538055,163
588,2020-04-03T17:00:00,ITA,11,43.61675973,13.5188753,982,158,1140,2491,3631,76,132,42,557,4230,13678,,Marche,1538055,163
589,2020-04-04T17:00:00,ITA,11,43.61675973,13.5188753,997,153,1150,2347,3497,-134,111,270,574,4341,14472,,Marche,1538055,163
590,2020-04-05T17:00:00,ITA,11,43.61675973,13.5188753,987,151,1138,2440,3578,81,123,287,599,4464,15252,,Marche,1538055,163
591,2020-04-06T17:00:00,ITA,11,43.61675973,13.5188753,1001,140,1141,2565,3706,128,150,296,612,4614,15919,,Marche,1538055,163
592,2020-04-07T17:00:00,ITA,11,43.61675973,13.5188753,962,139,1101,2637,3738,32,96,342,630,4710,16619,,Marche,1538055,163
593,2020-04-08T17:00:00,ITA,11,43.61675973,13.5188753,974,133,1107,2455,3562,-176,149,645,652,4859,17532,,Marche,1538055,163
594,2020-04-09T17:00:00,ITA,11,43.61675973,13.5188753,945,133,1078,2323,3401,-161,96,885,669,4955,18194,,Marche,1538055,163
595,2020-04-10T17:00:00,ITA,11,43.61675973,13.5188753,925,127,1052,2264,3316,-85,129,1086,682,5084,18970,,Marche,1538055,163
596,2020-04-11T17:00:00,ITA,11,43.61675973,13.5188753,960,118,1078,2153,3231,-85,127,1291,689,5211,20060,,Marche,1538055,163
597,2020-04-12T17:00:00,ITA,11,43.61675973,13.5188753,949,114,1063,2051,3114,-117,92,1489,700,5303,21057,,Marche,1538055,163
598,2020-04-13T17:00:00,ITA,11,43.61675973,13.5188753,959,108,1067,2013,3080,-34,78,1588,713,5381,28379,,Marche,1538055,163
599,2020-04-14T17:00:00,ITA,11,43.61675973,13.5188753,937,106,1043,2052,3095,15,45,1603,728,5426,29160,,Marche,1538055,163
600,2020-04-15T17:00:00,ITA,11,43.61675973,13.5188753,888,106,994,2103,3097,2,77,1660,746,5503,30329,,Marche,1538055,163
601,2020-04-16T17:00:00,ITA,11,43.61675973,13.5188753,850,102,952,2172,3124,27,79,1694,764,5582,33778,,Marche,1538055,163
602,2020-04-17T17:00:00,ITA,11,43.61675973,13.5188753,839,94,933,2224,3157,33,86,1726,785,5668,37997,,Marche,1538055,163
603,2020-04-18T17:00:00,ITA,11,43.61675973,13.5188753,804,88,892,2280,3172,15,53,1754,795,5721,39909,,Marche,1538055,163
604,2020-04-19T17:00:00,ITA,11,43.61675973,13.5188753,799,86,885,2297,3182,10,48,1780,807,5769,41474,27099.0,Marche,1538055,163
605,2020-04-20T17:00:00,ITA,11,43.61675973,13.5188753,792,80,872,2340,3212,30,57,1792,822,5826,42782,28006.0,Marche,1538055,163
606,2020-04-21T17:00:00,ITA,11,43.61675973,13.5188753,784,78,862,2356,3218,6,51,1825,834,5877,44332,29090.0,Marche,1538055,163
607,2020-04-22T17:00:00,ITA,11,43.61675973,13.5188753,735,76,811,2419,3230,12,47,1849,845,5924,46492,30543.0,Marche,1538055,163
608,2020-04-23T17:00:00,ITA,11,43.61675973,13.5188753,727,71,798,2432,3230,0,28,1865,857,5952,47662,31673.0,Marche,1538055,163
609,2020-04-24T17:00:00,ITA,11,43.61675973,13.5188753,705,61,766,2507,3273,43,76,1890,865,6028,49163,33113.0,Marche,1538055,163
610,2020-02-24T18:00:00,ITA,14,41.55774754,14.65916051,0,0,0,0,0,0,0,0,0,0,0,,Molise,310449,27
611,2020-02-25T18:00:00,ITA,14,41.55774754,14.65916051,0,0,0,0,0,0,0,0,0,0,0,,Molise,310449,27
612,2020-02-26T18:00:00,ITA,14,41.55774754,14.65916051,0,0,0,0,0,0,0,0,0,0,0,,Molise,310449,27
613,2020-02-27T18:00:00,ITA,14,41.55774754,14.65916051,0,0,0,0,0,0,0,0,0,0,0,,Molise,310449,27
614,2020-02-28T18:00:00,ITA,14,41.55774754,14.65916051,0,0,0,0,0,0,0,0,0,0,0,,Molise,310449,27
615,2020-02-29T17:00:00,ITA,14,41.55774754,14.65916051,0,0,0,0,0,0,0,0,0,0,0,,Molise,310449,27
616,2020-03-01T17:00:00,ITA,14,41.55774754,14.65916051,0,0,0,0,0,0,0,0,0,0,6,,Molise,310449,27
617,2020-03-02T18:00:00,ITA,14,41.55774754,14.65916051,0,0,0,0,0,0,0,0,0,0,13,,Molise,310449,27
618,2020-03-03T18:00:00,ITA,14,41.55774754,14.65916051,3,0,3,0,3,3,3,0,0,3,13,,Molise,310449,27
619,2020-03-04T17:00:00,ITA,14,41.55774754,14.65916051,3,0,3,0,3,0,0,0,0,3,19,,Molise,310449,27
620,2020-03-05T17:00:00,ITA,14,41.55774754,14.65916051,4,0,4,3,7,4,4,0,0,7,24,,Molise,310449,27
621,2020-03-06T17:00:00,ITA,14,41.55774754,14.65916051,3,2,5,7,12,5,5,0,0,12,104,,Molise,310449,27
622,2020-03-07T18:00:00,ITA,14,41.55774754,14.65916051,3,2,5,9,14,2,2,0,0,14,112,,Molise,310449,27
623,2020-03-08T18:00:00,ITA,14,41.55774754,14.65916051,4,2,6,8,14,0,0,0,0,14,116,,Molise,310449,27
624,2020-03-09T18:00:00,ITA,14,41.55774754,14.65916051,4,2,6,8,14,0,0,0,0,14,212,,Molise,310449,27
625,2020-03-10T18:00:00,ITA,14,41.55774754,14.65916051,3,3,6,9,15,1,1,0,0,15,225,,Molise,310449,27
626,2020-03-11T17:00:00,ITA,14,41.55774754,14.65916051,4,3,7,9,16,1,1,0,0,16,233,,Molise,310449,27
627,2020-03-12T17:00:00,ITA,14,41.55774754,14.65916051,4,3,7,9,16,0,0,0,0,16,238,,Molise,310449,27
628,2020-03-13T17:00:00,ITA,14,41.55774754,14.65916051,5,3,8,9,17,1,1,0,0,17,243,,Molise,310449,27
629,2020-03-14T17:00:00,ITA,14,41.55774754,14.65916051,5,3,8,9,17,0,0,0,0,17,247,,Molise,310449,27
630,2020-03-15T17:00:00,ITA,14,41.55774754,14.65916051,3,4,7,10,17,0,0,0,0,17,248,,Molise,310449,27
631,2020-03-16T17:00:00,ITA,14,41.55774754,14.65916051,3,5,8,7,15,-2,4,5,1,21,253,,Molise,310449,27
632,2020-03-17T17:00:00,ITA,14,41.55774754,14.65916051,7,5,12,7,19,4,4,5,1,25,301,,Molise,310449,27
633,2020-03-18T17:00:00,ITA,14,41.55774754,14.65916051,7,6,13,8,21,2,3,6,1,28,361,,Molise,310449,27
634,2020-03-19T17:00:00,ITA,14,41.55774754,14.65916051,19,6,25,13,38,17,18,6,2,46,426,,Molise,310449,27
635,2020-03-20T17:00:00,ITA,14,41.55774754,14.65916051,20,6,26,13,39,1,4,6,5,50,426,,Molise,310449,27
636,2020-03-21T17:00:00,ITA,14,41.55774754,14.65916051,21,6,27,20,47,8,11,7,7,61,449,,Molise,310449,27
637,2020-03-22T17:00:00,ITA,14,41.55774754,14.65916051,24,7,31,21,52,5,5,7,7,66,532,,Molise,310449,27
638,2020-03-23T17:00:00,ITA,14,41.55774754,14.65916051,25,7,32,18,50,-2,1,10,7,67,532,,Molise,310449,27
639,2020-03-24T17:00:00,ITA,14,41.55774754,14.65916051,27,7,34,21,55,5,6,10,8,73,572,,Molise,310449,27
640,2020-03-25T17:00:00,ITA,14,41.55774754,14.65916051,26,7,33,20,53,-2,0,12,8,73,580,,Molise,310449,27
641,2020-03-26T17:00:00,ITA,14,41.55774754,14.65916051,27,8,35,46,81,28,30,14,8,103,670,,Molise,310449,27
642,2020-03-27T17:00:00,ITA,14,41.55774754,14.65916051,26,9,35,51,86,5,6,14,9,109,710,,Molise,310449,27
643,2020-03-28T17:00:00,ITA,14,41.55774754,14.65916051,26,9,35,63,98,12,14,16,9,123,807,,Molise,310449,27
644,2020-03-29T17:00:00,ITA,14,41.55774754,14.65916051,25,9,34,66,100,2,4,18,9,127,918,,Molise,310449,27
645,2020-03-30T17:00:00,ITA,14,41.55774754,14.65916051,27,8,35,72,107,7,7,18,9,134,955,,Molise,310449,27
646,2020-03-31T17:00:00,ITA,14,41.55774754,14.65916051,29,8,37,80,117,10,10,18,9,144,1049,,Molise,310449,27
647,2020-04-01T17:00:00,ITA,14,41.55774754,14.65916051,32,8,40,91,131,14,16,19,10,160,1157,,Molise,310449,27
648,2020-04-02T17:00:00,ITA,14,41.55774754,14.65916051,30,8,38,95,133,2,5,21,11,165,1229,,Molise,310449,27
649,2020-04-03T17:00:00,ITA,14,41.55774754,14.65916051,31,8,39,105,144,11,11,21,11,176,1378,,Molise,310449,27
650,2020-04-04T17:00:00,ITA,14,41.55774754,14.65916051,31,6,37,134,171,27,30,24,11,206,1504,,Molise,310449,27
651,2020-04-05T17:00:00,ITA,14,41.55774754,14.65916051,33,6,39,148,187,16,18,24,13,224,1504,,Molise,310449,27
652,2020-04-06T17:00:00,ITA,14,41.55774754,14.65916051,34,5,39,148,187,0,0,24,13,224,1546,,Molise,310449,27
653,2020-04-07T17:00:00,ITA,14,41.55774754,14.65916051,35,5,40,145,185,-2,0,26,13,224,1581,,Molise,310449,27
654,2020-04-08T17:00:00,ITA,14,41.55774754,14.65916051,30,4,34,147,181,-4,2,32,13,226,2002,,Molise,310449,27
655,2020-04-09T17:00:00,ITA,14,41.55774754,14.65916051,30,4,34,155,189,8,8,32,13,234,2069,,Molise,310449,27
656,2020-04-10T17:00:00,ITA,14,41.55774754,14.65916051,28,4,32,161,193,4,9,37,13,243,2069,,Molise,310449,27
657,2020-04-11T17:00:00,ITA,14,41.55774754,14.65916051,28,4,32,161,193,0,3,39,14,246,2201,,Molise,310449,27
658,2020-04-12T17:00:00,ITA,14,41.55774754,14.65916051,27,4,31,171,202,9,11,40,15,257,2471,,Molise,310449,27
659,2020-04-13T17:00:00,ITA,14,41.55774754,14.65916051,28,4,32,170,202,0,0,40,15,257,2522,,Molise,310449,27
660,2020-04-14T17:00:00,ITA,14,41.55774754,14.65916051,26,4,30,170,200,-2,0,42,15,257,2522,,Molise,310449,27
661,2020-04-15T17:00:00,ITA,14,41.55774754,14.65916051,27,4,31,175,206,6,6,42,15,263,2855,,Molise,310449,27
662,2020-04-16T17:00:00,ITA,14,41.55774754,14.65916051,25,4,29,174,203,-3,0,44,16,263,2967,,Molise,310449,27
663,2020-04-17T17:00:00,ITA,14,41.55774754,14.65916051,26,4,30,178,208,5,6,45,16,269,3082,,Molise,310449,27
664,2020-04-18T17:00:00,ITA,14,41.55774754,14.65916051,27,4,31,178,209,1,0,44,16,269,3082,,Molise,310449,27
665,2020-04-19T17:00:00,ITA,14,41.55774754,14.65916051,27,4,31,184,215,6,10,47,17,279,3584,3482.0,Molise,310449,27
666,2020-04-20T17:00:00,ITA,14,41.55774754,14.65916051,27,2,29,184,213,-2,2,50,18,281,3783,3683.0,Molise,310449,27
667,2020-04-21T17:00:00,ITA,14,41.55774754,14.65916051,27,2,29,184,213,0,1,51,18,282,4124,4015.0,Molise,310449,27
668,2020-04-22T17:00:00,ITA,14,41.55774754,14.65916051,21,2,23,182,205,-8,2,60,19,284,4425,4252.0,Molise,310449,27
669,2020-04-23T17:00:00,ITA,14,41.55774754,14.65916051,19,1,20,178,198,-7,0,66,20,284,4564,4478.0,Molise,310449,27
670,2020-04-24T17:00:00,ITA,14,41.55774754,14.65916051,19,1,20,180,200,2,3,67,20,287,4805,4718.0,Molise,310449,27
671,2020-02-24T18:00:00,ITA,1,45.0732745,7.680687483,2,0,2,1,3,0,3,0,0,3,141,,Piemonte,4392526,420
672,2020-02-25T18:00:00,ITA,1,45.0732745,7.680687483,2,0,2,1,3,0,0,0,0,3,141,,Piemonte,4392526,420
673,2020-02-26T18:00:00,ITA,1,45.0732745,7.680687483,2,0,2,1,3,0,0,0,0,3,156,,Piemonte,4392526,420
674,2020-02-27T18:00:00,ITA,1,45.0732745,7.680687483,2,0,2,0,2,-1,-1,0,0,2,156,,Piemonte,4392526,420
675,2020-02-28T18:00:00,ITA,1,45.0732745,7.680687483,7,0,7,4,11,9,9,0,0,11,227,,Piemonte,4392526,420
676,2020-02-29T17:00:00,ITA,1,45.0732745,7.680687483,7,0,7,4,11,0,0,0,0,11,308,,Piemonte,4392526,420
677,2020-03-01T17:00:00,ITA,1,45.0732745,7.680687483,11,2,13,36,49,38,38,0,0,49,362,,Piemonte,4392526,420
678,2020-03-02T18:00:00,ITA,1,45.0732745,7.680687483,12,2,14,37,51,2,2,0,0,51,434,,Piemonte,4392526,420
679,2020-03-03T18:00:00,ITA,1,45.0732745,7.680687483,13,3,16,40,56,5,5,0,0,56,458,,Piemonte,4392526,420
680,2020-03-04T17:00:00,ITA,1,45.0732745,7.680687483,26,13,39,43,82,26,26,0,0,82,543,,Piemonte,4392526,420
681,2020-03-05T17:00:00,ITA,1,45.0732745,7.680687483,43,17,60,46,106,24,26,0,2,108,543,,Piemonte,4392526,420
682,2020-03-06T17:00:00,ITA,1,45.0732745,7.680687483,57,30,87,52,139,33,35,0,4,143,793,,Piemonte,4392526,420
683,2020-03-07T18:00:00,ITA,1,45.0732745,7.680687483,110,38,148,54,202,63,64,0,5,207,1046,,Piemonte,4392526,420
684,2020-03-08T18:00:00,ITA,1,45.0732745,7.680687483,245,45,290,65,355,153,153,0,5,360,1636,,Piemonte,4392526,420
685,2020-03-09T18:00:00,ITA,1,45.0732745,7.680687483,222,50,272,65,337,-18,-10,0,13,350,1681,,Piemonte,4392526,420
686,2020-03-10T18:00:00,ITA,1,45.0732745,7.680687483,306,66,372,64,436,99,103,0,17,453,2374,,Piemonte,4392526,420
687,2020-03-11T17:00:00,ITA,1,45.0732745,7.680687483,319,75,394,86,480,44,48,0,21,501,2431,,Piemonte,4392526,420
688,2020-03-12T17:00:00,ITA,1,45.0732745,7.680687483,368,97,465,89,554,74,79,0,26,580,2879,,Piemonte,4392526,420
689,2020-03-13T17:00:00,ITA,1,45.0732745,7.680687483,556,135,691,103,794,240,260,0,46,840,3105,,Piemonte,4392526,420
690,2020-03-14T17:00:00,ITA,1,45.0732745,7.680687483,538,150,688,126,814,20,33,0,59,873,3680,,Piemonte,4392526,420
691,2020-03-15T17:00:00,ITA,1,45.0732745,7.680687483,726,171,897,133,1030,216,238,0,81,1111,4375,,Piemonte,4392526,420
692,2020-03-16T17:00:00,ITA,1,45.0732745,7.680687483,1045,186,1231,174,1405,375,405,0,111,1516,5588,,Piemonte,4392526,420
693,2020-03-17T17:00:00,ITA,1,45.0732745,7.680687483,1378,206,1584,180,1764,359,381,0,133,1897,6543,,Piemonte,4392526,420
694,2020-03-18T17:00:00,ITA,1,45.0732745,7.680687483,1780,227,2007,180,2187,423,444,0,154,2341,7516,,Piemonte,4392526,420
695,2020-03-19T17:00:00,ITA,1,45.0732745,7.680687483,2279,257,2536,218,2754,567,591,3,175,2932,8853,,Piemonte,4392526,420
696,2020-03-20T17:00:00,ITA,1,45.0732745,7.680687483,1541,280,1821,1423,3244,490,529,8,209,3461,9975,,Piemonte,4392526,420
697,2020-03-21T17:00:00,ITA,1,45.0732745,7.680687483,1976,301,2277,1229,3506,262,291,8,238,3752,10701,,Piemonte,4392526,420
698,2020-03-22T17:00:00,ITA,1,45.0732745,7.680687483,2118,308,2426,1701,4127,621,668,10,283,4420,12701,,Piemonte,4392526,420
699,2020-03-23T17:00:00,ITA,1,45.0732745,7.680687483,2194,343,2537,1992,4529,402,441,17,315,4861,13560,,Piemonte,4392526,420
700,2020-03-24T17:00:00,ITA,1,45.0732745,7.680687483,2404,360,2764,2360,5124,595,654,17,374,5515,15469,,Piemonte,4392526,420
701,2020-03-25T17:00:00,ITA,1,45.0732745,7.680687483,2544,381,2925,2631,5556,432,509,19,449,6024,16655,,Piemonte,4392526,420
702,2020-03-26T17:00:00,ITA,1,45.0732745,7.680687483,2633,408,3041,2909,5950,394,510,135,449,6534,18054,,Piemonte,4392526,420
703,2020-03-27T17:00:00,ITA,1,45.0732745,7.680687483,2852,431,3283,3064,6347,397,558,176,569,7092,19705,,Piemonte,4392526,420
704,2020-03-28T17:00:00,ITA,1,45.0732745,7.680687483,3094,439,3533,3318,6851,504,579,203,617,7671,21511,,Piemonte,4392526,420
705,2020-03-29T17:00:00,ITA,1,45.0732745,7.680687483,2985,443,3428,3840,7268,417,535,254,684,8206,24058,,Piemonte,4392526,420
706,2020-03-30T17:00:00,ITA,1,45.0732745,7.680687483,2985,452,3437,4218,7655,387,506,308,749,8712,25478,,Piemonte,4392526,420
707,2020-03-31T17:00:00,ITA,1,45.0732745,7.680687483,3174,452,3626,4456,8082,427,589,365,854,9301,27658,,Piemonte,4392526,420
708,2020-04-01T17:00:00,ITA,1,45.0732745,7.680687483,3146,453,3599,4871,8470,388,494,439,886,9795,30060,,Piemonte,4392526,420
709,2020-04-02T17:00:00,ITA,1,45.0732745,7.680687483,3341,453,3794,5005,8799,329,558,571,983,10353,32100,,Piemonte,4392526,420
710,2020-04-03T17:00:00,ITA,1,45.0732745,7.680687483,3300,452,3752,5378,9130,331,543,723,1043,10896,34281,,Piemonte,4392526,420
711,2020-04-04T17:00:00,ITA,1,45.0732745,7.680687483,3441,450,3891,5802,9693,563,813,888,1128,11709,37181,,Piemonte,4392526,420
712,2020-04-05T17:00:00,ITA,1,45.0732745,7.680687483,3472,444,3916,6261,10177,484,653,1017,1168,12362,38539,,Piemonte,4392526,420
713,2020-04-06T17:00:00,ITA,1,45.0732745,7.680687483,3484,438,3922,6623,10545,368,562,1128,1251,12924,41123,,Piemonte,4392526,420
714,2020-04-07T17:00:00,ITA,1,45.0732745,7.680687483,3553,432,3985,6719,10704,159,419,1320,1319,13343,44121,,Piemonte,4392526,420
715,2020-04-08T17:00:00,ITA,1,45.0732745,7.680687483,3493,423,3916,7073,10989,285,540,1516,1378,13883,48495,,Piemonte,4392526,420
716,2020-04-09T17:00:00,ITA,1,45.0732745,7.680687483,3514,412,3926,7410,11336,347,639,1732,1454,14522,52807,,Piemonte,4392526,420
717,2020-04-10T17:00:00,ITA,1,45.0732745,7.680687483,3497,394,3891,7685,11576,240,490,1904,1532,15012,57457,,Piemonte,4392526,420
718,2020-04-11T17:00:00,ITA,1,45.0732745,7.680687483,3435,384,3819,8351,12170,594,996,2205,1633,16008,62577,,Piemonte,4392526,420
719,2020-04-12T17:00:00,ITA,1,45.0732745,7.680687483,3429,381,3810,8695,12505,335,652,2426,1729,16660,66555,,Piemonte,4392526,420
720,2020-04-13T17:00:00,ITA,1,45.0732745,7.680687483,3344,379,3723,9042,12765,260,474,2543,1826,17134,69170,,Piemonte,4392526,420
721,2020-04-14T17:00:00,ITA,1,45.0732745,7.680687483,3395,367,3762,9293,13055,290,556,2708,1927,17690,71678,,Piemonte,4392526,420
722,2020-04-15T17:00:00,ITA,1,45.0732745,7.680687483,3338,366,3704,9491,13195,140,539,3019,2015,18229,75664,,Piemonte,4392526,420
723,2020-04-16T17:00:00,ITA,1,45.0732745,7.680687483,3418,346,3764,10019,13783,588,879,3231,2094,19108,80708,,Piemonte,4392526,420
724,2020-04-17T17:00:00,ITA,1,45.0732745,7.680687483,3266,333,3599,10399,13998,215,695,3634,2171,19803,86714,,Piemonte,4392526,420
725,2020-04-18T17:00:00,ITA,1,45.0732745,7.680687483,3271,323,3594,10629,14223,225,661,3989,2252,20464,91844,,Piemonte,4392526,420
726,2020-04-19T17:00:00,ITA,1,45.0732745,7.680687483,3201,305,3506,10964,14470,247,593,4256,2331,21057,96569,71644.0,Piemonte,4392526,420
727,2020-04-20T17:00:00,ITA,1,45.0732745,7.680687483,3299,301,3600,10957,14557,87,292,4383,2409,21349,99669,73192.0,Piemonte,4392526,420
728,2020-04-21T17:00:00,ITA,1,45.0732745,7.680687483,3116,293,3409,11402,14811,254,606,4659,2485,21955,105434,76406.0,Piemonte,4392526,420
729,2020-04-22T17:00:00,ITA,1,45.0732745,7.680687483,3213,273,3486,11636,15122,311,784,5058,2559,22739,111513,81176.0,Piemonte,4392526,420
730,2020-04-23T17:00:00,ITA,1,45.0732745,7.680687483,3039,261,3300,11852,15152,30,401,5358,2630,23140,117970,84648.0,Piemonte,4392526,420
731,2020-04-24T17:00:00,ITA,1,45.0732745,7.680687483,2918,257,3175,12216,15391,239,682,5732,2699,23822,125300,89392.0,Piemonte,4392526,420
732,2020-02-24T18:00:00,ITA,16,41.12559576,16.86736689,0,0,0,0,0,0,0,0,0,0,0,,Puglia,4063888,306
733,2020-02-25T18:00:00,ITA,16,41.12559576,16.86736689,0,0,0,0,0,0,0,0,0,0,0,,Puglia,4063888,306
734,2020-02-26T18:00:00,ITA,16,41.12559576,16.86736689,0,0,0,0,0,0,0,0,0,0,0,,Puglia,4063888,306
735,2020-02-27T18:00:00,ITA,16,41.12559576,16.86736689,1,0,1,0,1,1,1,0,0,1,0,,Puglia,4063888,306
736,2020-02-28T18:00:00,ITA,16,41.12559576,16.86736689,1,0,1,2,3,2,2,0,0,3,242,,Puglia,4063888,306
737,2020-02-29T17:00:00,ITA,16,41.12559576,16.86736689,1,0,1,2,3,0,0,0,0,3,252,,Puglia,4063888,306
738,2020-03-01T17:00:00,ITA,16,41.12559576,16.86736689,1,0,1,2,3,0,0,0,0,3,262,,Puglia,4063888,306
739,2020-03-02T18:00:00,ITA,16,41.12559576,16.86736689,2,0,2,2,4,1,1,0,0,4,278,,Puglia,4063888,306
740,2020-03-03T18:00:00,ITA,16,41.12559576,16.86736689,2,0,2,4,6,2,2,0,0,6,298,,Puglia,4063888,306
741,2020-03-04T17:00:00,ITA,16,41.12559576,16.86736689,4,0,4,3,7,1,3,1,1,9,322,,Puglia,4063888,306
742,2020-03-05T17:00:00,ITA,16,41.12559576,16.86736689,5,1,6,6,12,5,5,1,1,14,359,,Puglia,4063888,306
743,2020-03-06T17:00:00,ITA,16,41.12559576,16.86736689,5,1,6,9,15,3,3,1,1,17,395,,Puglia,4063888,306
744,2020-03-07T18:00:00,ITA,16,41.12559576,16.86736689,9,2,11,12,23,8,9,1,2,26,395,,Puglia,4063888,306
745,2020-03-08T18:00:00,ITA,16,41.12559576,16.86736689,17,3,20,16,36,13,14,1,3,40,627,,Puglia,4063888,306
746,2020-03-09T18:00:00,ITA,16,41.12559576,16.86736689,20,6,26,20,46,10,10,1,3,50,685,,Puglia,4063888,306
747,2020-03-10T18:00:00,ITA,16,41.12559576,16.86736689,28,6,34,21,55,9,9,1,3,59,747,,Puglia,4063888,306
748,2020-03-11T17:00:00,ITA,16,41.12559576,16.86736689,38,4,42,29,71,16,18,1,5,77,909,,Puglia,4063888,306
749,2020-03-12T17:00:00,ITA,16,41.12559576,16.86736689,58,2,60,38,98,27,27,1,5,104,1269,,Puglia,4063888,306
750,2020-03-13T17:00:00,ITA,16,41.12559576,16.86736689,77,2,79,42,121,23,25,3,5,129,1449,,Puglia,4063888,306
751,2020-03-14T17:00:00,ITA,16,41.12559576,16.86736689,91,6,97,59,156,35,37,2,8,166,1681,,Puglia,4063888,306
752,2020-03-15T17:00:00,ITA,16,41.12559576,16.86736689,116,6,122,90,212,56,64,2,16,230,2017,,Puglia,4063888,306
753,2020-03-16T17:00:00,ITA,16,41.12559576,16.86736689,116,6,122,90,212,0,0,2,16,230,2017,,Puglia,4063888,306
754,2020-03-17T17:00:00,ITA,16,41.12559576,16.86736689,155,14,169,151,320,108,110,2,18,340,3077,,Puglia,4063888,306
755,2020-03-18T17:00:00,ITA,16,41.12559576,16.86736689,156,30,186,176,362,42,43,2,19,383,3433,,Puglia,4063888,306
756,2020-03-19T17:00:00,ITA,16,41.12559576,16.86736689,173,31,204,245,449,87,95,4,25,478,4046,,Puglia,4063888,306
757,2020-03-20T17:00:00,ITA,16,41.12559576,16.86736689,191,31,222,329,551,102,103,4,26,581,4789,,Puglia,4063888,306
758,2020-03-21T17:00:00,ITA,16,41.12559576,16.86736689,209,33,242,400,642,91,94,4,29,675,5617,,Puglia,4063888,306
759,2020-03-22T17:00:00,ITA,16,41.12559576,16.86736689,252,37,289,459,748,106,111,7,31,786,6160,,Puglia,4063888,306
760,2020-03-23T17:00:00,ITA,16,41.12559576,16.86736689,285,45,330,532,862,114,120,7,37,906,6761,,Puglia,4063888,306
761,2020-03-24T17:00:00,ITA,16,41.12559576,16.86736689,317,57,374,566,940,78,99,21,44,1005,7345,,Puglia,4063888,306
762,2020-03-25T17:00:00,ITA,16,41.12559576,16.86736689,349,64,413,610,1023,83,88,22,48,1093,8223,,Puglia,4063888,306
763,2020-03-26T17:00:00,ITA,16,41.12559576,16.86736689,480,76,556,539,1095,72,89,22,65,1182,9191,,Puglia,4063888,306
764,2020-03-27T17:00:00,ITA,16,41.12559576,16.86736689,530,82,612,624,1236,141,152,29,69,1334,10233,,Puglia,4063888,306
765,2020-03-28T17:00:00,ITA,16,41.12559576,16.86736689,563,98,661,697,1358,122,124,29,71,1458,11500,,Puglia,4063888,306
766,2020-03-29T17:00:00,ITA,16,41.12559576,16.86736689,559,99,658,774,1432,74,91,31,86,1549,12361,,Puglia,4063888,306
767,2020-03-30T17:00:00,ITA,16,41.12559576,16.86736689,590,106,696,889,1585,153,163,36,91,1712,13117,,Puglia,4063888,306
768,2020-03-31T17:00:00,ITA,16,41.12559576,16.86736689,609,105,714,940,1654,69,91,39,110,1803,14073,,Puglia,4063888,306
769,2020-04-01T17:00:00,ITA,16,41.12559576,16.86736689,637,107,744,1012,1756,102,143,61,129,1946,15209,,Puglia,4063888,306
770,2020-04-02T17:00:00,ITA,16,41.12559576,16.86736689,645,118,763,1101,1864,108,131,69,144,2077,16554,,Puglia,4063888,306
771,2020-04-03T17:00:00,ITA,16,41.12559576,16.86736689,648,123,771,1178,1949,85,105,69,164,2182,17924,,Puglia,4063888,306
772,2020-04-04T17:00:00,ITA,16,41.12559576,16.86736689,627,153,780,1193,1973,24,58,94,173,2240,18977,,Puglia,4063888,306
773,2020-04-05T17:00:00,ITA,16,41.12559576,16.86736689,574,159,733,1289,2022,49,77,113,182,2317,20080,,Puglia,4063888,306
774,2020-04-06T17:00:00,ITA,16,41.12559576,16.86736689,625,97,722,1393,2115,93,127,134,195,2444,22059,,Puglia,4063888,306
775,2020-04-07T17:00:00,ITA,16,41.12559576,16.86736689,615,93,708,1429,2137,22,70,168,209,2514,23149,,Puglia,4063888,306
776,2020-04-08T17:00:00,ITA,16,41.12559576,16.86736689,639,90,729,1509,2238,101,120,177,219,2634,24493,,Puglia,4063888,306
777,2020-04-09T17:00:00,ITA,16,41.12559576,16.86736689,630,86,716,1585,2301,63,82,190,225,2716,26088,,Puglia,4063888,306
778,2020-04-10T17:00:00,ITA,16,41.12559576,16.86736689,631,80,711,1625,2336,35,93,235,238,2809,27812,,Puglia,4063888,306
779,2020-04-11T17:00:00,ITA,16,41.12559576,16.86736689,627,73,700,1702,2402,66,95,249,253,2904,29463,,Puglia,4063888,306
780,2020-04-12T17:00:00,ITA,16,41.12559576,16.86736689,609,71,680,1772,2452,50,85,277,260,2989,30973,,Puglia,4063888,306
781,2020-04-13T17:00:00,ITA,16,41.12559576,16.86736689,600,71,671,1841,2512,60,76,286,267,3065,31922,,Puglia,4063888,306
782,2020-04-14T17:00:00,ITA,16,41.12559576,16.86736689,611,62,673,1879,2552,40,53,288,278,3118,33071,,Puglia,4063888,306
783,2020-04-15T17:00:00,ITA,16,41.12559576,16.86736689,592,73,665,1908,2573,21,66,323,288,3184,34518,,Puglia,4063888,306
784,2020-04-16T17:00:00,ITA,16,41.12559576,16.86736689,603,58,661,1964,2625,52,74,334,299,3258,36158,,Puglia,4063888,306
785,2020-04-17T17:00:00,ITA,16,41.12559576,16.86736689,590,62,652,2004,2656,31,69,364,307,3327,38278,,Puglia,4063888,306
786,2020-04-18T17:00:00,ITA,16,41.12559576,16.86736689,594,60,654,2040,2694,38,82,401,314,3409,40423,,Puglia,4063888,306
787,2020-04-19T17:00:00,ITA,16,41.12559576,16.86736689,590,60,650,2136,2786,92,120,427,316,3529,42598,41580.0,Puglia,4063888,306
788,2020-04-20T17:00:00,ITA,16,41.12559576,16.86736689,584,66,650,2160,2810,24,38,431,326,3567,44189,43119.0,Puglia,4063888,306
789,2020-04-21T17:00:00,ITA,16,41.12559576,16.86736689,569,65,634,2178,2812,2,55,459,351,3622,45984,44760.0,Puglia,4063888,306
790,2020-04-22T17:00:00,ITA,16,41.12559576,16.86736689,564,60,624,2250,2874,62,108,494,362,3730,48342,46925.0,Puglia,4063888,306
791,2020-04-23T17:00:00,ITA,16,41.12559576,16.86736689,536,55,591,2345,2936,62,109,531,372,3839,50410,49403.0,Puglia,4063888,306
792,2020-04-24T17:00:00,ITA,16,41.12559576,16.86736689,496,51,547,2386,2933,-3,42,565,383,3881,52472,51517.0,Puglia,4063888,306
793,2020-02-24T18:00:00,ITA,20,39.21531192,9.110616306,0,0,0,0,0,0,0,0,0,0,1,,Sardegna,1653135,163
794,2020-02-25T18:00:00,ITA,20,39.21531192,9.110616306,0,0,0,0,0,0,0,0,0,0,1,,Sardegna,1653135,163
795,2020-02-26T18:00:00,ITA,20,39.21531192,9.110616306,0,0,0,0,0,0,0,0,0,0,1,,Sardegna,1653135,163
796,2020-02-27T18:00:00,ITA,20,39.21531192,9.110616306,0,0,0,0,0,0,0,0,0,0,1,,Sardegna,1653135,163
797,2020-02-28T18:00:00,ITA,20,39.21531192,9.110616306,0,0,0,0,0,0,0,0,0,0,1,,Sardegna,1653135,163
798,2020-02-29T17:00:00,ITA,20,39.21531192,9.110616306,0,0,0,0,0,0,0,0,0,0,1,,Sardegna,1653135,163
799,2020-03-01T17:00:00,ITA,20,39.21531192,9.110616306,0,0,0,0,0,0,0,0,0,0,29,,Sardegna,1653135,163
800,2020-03-02T18:00:00,ITA,20,39.21531192,9.110616306,0,0,0,0,0,0,0,0,0,0,29,,Sardegna,1653135,163
801,2020-03-03T18:00:00,ITA,20,39.21531192,9.110616306,1,0,1,0,1,1,1,0,0,1,29,,Sardegna,1653135,163
802,2020-03-04T17:00:00,ITA,20,39.21531192,9.110616306,1,0,1,1,2,1,1,0,0,2,42,,Sardegna,1653135,163
803,2020-03-05T17:00:00,ITA,20,39.21531192,9.110616306,2,0,2,0,2,0,0,0,0,2,50,,Sardegna,1653135,163
804,2020-03-06T17:00:00,ITA,20,39.21531192,9.110616306,2,0,2,3,5,3,3,0,0,5,99,,Sardegna,1653135,163
805,2020-03-07T18:00:00,ITA,20,39.21531192,9.110616306,2,0,2,3,5,0,0,0,0,5,99,,Sardegna,1653135,163
806,2020-03-08T18:00:00,ITA,20,39.21531192,9.110616306,5,0,5,6,11,6,6,0,0,11,149,,Sardegna,1653135,163
807,2020-03-09T18:00:00,ITA,20,39.21531192,9.110616306,8,0,8,11,19,8,8,0,0,19,185,,Sardegna,1653135,163
808,2020-03-10T18:00:00,ITA,20,39.21531192,9.110616306,9,0,9,11,20,1,1,0,0,20,204,,Sardegna,1653135,163
809,2020-03-11T17:00:00,ITA,20,39.21531192,9.110616306,10,0,10,27,37,17,17,0,0,37,283,,Sardegna,1653135,163
810,2020-03-12T17:00:00,ITA,20,39.21531192,9.110616306,12,0,12,27,39,2,2,0,0,39,302,,Sardegna,1653135,163
811,2020-03-13T17:00:00,ITA,20,39.21531192,9.110616306,12,0,12,31,43,4,4,0,0,43,504,,Sardegna,1653135,163
812,2020-03-14T17:00:00,ITA,20,39.21531192,9.110616306,14,0,14,33,47,4,4,0,0,47,530,,Sardegna,1653135,163
813,2020-03-15T17:00:00,ITA,20,39.21531192,9.110616306,16,0,16,59,75,28,30,0,2,77,613,,Sardegna,1653135,163
814,2020-03-16T17:00:00,ITA,20,39.21531192,9.110616306,39,0,39,66,105,30,30,0,2,107,797,,Sardegna,1653135,163
815,2020-03-17T17:00:00,ITA,20,39.21531192,9.110616306,36,4,40,75,115,10,10,0,2,117,1003,,Sardegna,1653135,163
816,2020-03-18T17:00:00,ITA,20,39.21531192,9.110616306,42,7,49,83,132,17,17,0,2,134,1135,,Sardegna,1653135,163
817,2020-03-19T17:00:00,ITA,20,39.21531192,9.110616306,43,9,52,152,204,72,72,0,2,206,1334,,Sardegna,1653135,163
818,2020-03-20T17:00:00,ITA,20,39.21531192,9.110616306,56,15,71,217,288,84,87,3,2,293,1912,,Sardegna,1653135,163
819,2020-03-21T17:00:00,ITA,20,39.21531192,9.110616306,65,16,81,240,321,33,37,5,4,330,2297,,Sardegna,1653135,163
820,2020-03-22T17:00:00,ITA,20,39.21531192,9.110616306,67,16,83,244,327,6,9,5,7,339,2402,,Sardegna,1653135,163
821,2020-03-23T17:00:00,ITA,20,39.21531192,9.110616306,76,18,94,249,343,16,20,5,11,359,2568,,Sardegna,1653135,163
822,2020-03-24T17:00:00,ITA,20,39.21531192,9.110616306,80,19,99,296,395,52,62,11,15,421,2859,,Sardegna,1653135,163
823,2020-03-25T17:00:00,ITA,20,39.21531192,9.110616306,82,19,101,311,412,17,21,12,18,442,3019,,Sardegna,1653135,163
824,2020-03-26T17:00:00,ITA,20,39.21531192,9.110616306,92,20,112,350,462,50,52,13,19,494,3461,,Sardegna,1653135,163
825,2020-03-27T17:00:00,ITA,20,39.21531192,9.110616306,93,19,112,384,496,34,36,13,21,530,3801,,Sardegna,1653135,163
826,2020-03-28T17:00:00,ITA,20,39.21531192,9.110616306,95,22,117,452,569,73,94,29,26,624,4225,,Sardegna,1653135,163
827,2020-03-29T17:00:00,ITA,20,39.21531192,9.110616306,105,23,128,454,582,13,14,29,27,638,4598,,Sardegna,1653135,163
828,2020-03-30T17:00:00,ITA,20,39.21531192,9.110616306,113,24,137,485,622,40,44,32,28,682,4993,,Sardegna,1653135,163
829,2020-03-31T17:00:00,ITA,20,39.21531192,9.110616306,113,28,141,516,657,35,40,34,31,722,5257,,Sardegna,1653135,163
830,2020-04-01T17:00:00,ITA,20,39.21531192,9.110616306,119,27,146,529,675,18,23,36,34,745,5501,,Sardegna,1653135,163
831,2020-04-02T17:00:00,ITA,20,39.21531192,9.110616306,117,24,141,577,718,43,49,36,40,794,5970,,Sardegna,1653135,163
832,2020-04-03T17:00:00,ITA,20,39.21531192,9.110616306,122,24,146,598,744,26,31,40,41,825,6478,,Sardegna,1653135,163
833,2020-04-04T17:00:00,ITA,20,39.21531192,9.110616306,123,24,147,642,789,45,49,44,41,874,6789,,Sardegna,1653135,163
834,2020-04-05T17:00:00,ITA,20,39.21531192,9.110616306,126,25,151,664,815,26,33,49,43,907,7157,,Sardegna,1653135,163
835,2020-04-06T17:00:00,ITA,20,39.21531192,9.110616306,123,26,149,670,819,4,15,56,47,922,7521,,Sardegna,1653135,163
836,2020-04-07T17:00:00,ITA,20,39.21531192,9.110616306,122,26,148,673,821,2,13,62,52,935,7680,,Sardegna,1653135,163
837,2020-04-08T17:00:00,ITA,20,39.21531192,9.110616306,112,31,143,697,840,19,40,76,59,975,8493,,Sardegna,1653135,163
838,2020-04-09T17:00:00,ITA,20,39.21531192,9.110616306,106,25,131,745,876,36,51,86,64,1026,8918,,Sardegna,1653135,163
839,2020-04-10T17:00:00,ITA,20,39.21531192,9.110616306,107,26,133,743,876,0,37,118,69,1063,9444,,Sardegna,1653135,163
840,2020-04-11T17:00:00,ITA,20,39.21531192,9.110616306,113,24,137,751,888,12,28,130,73,1091,10120,,Sardegna,1653135,163
841,2020-04-12T17:00:00,ITA,20,39.21531192,9.110616306,109,26,135,768,903,15,22,137,73,1113,10663,,Sardegna,1653135,163
842,2020-04-13T17:00:00,ITA,20,39.21531192,9.110616306,107,27,134,780,914,11,15,139,75,1128,11010,,Sardegna,1653135,163
843,2020-04-14T17:00:00,ITA,20,39.21531192,9.110616306,107,24,131,769,900,-14,10,158,80,1138,11893,,Sardegna,1653135,163
844,2020-04-15T17:00:00,ITA,20,39.21531192,9.110616306,107,26,133,737,870,-30,23,208,83,1161,12395,,Sardegna,1653135,163
845,2020-04-16T17:00:00,ITA,20,39.21531192,9.110616306,109,24,133,732,865,-5,3,214,85,1164,12796,,Sardegna,1653135,163
846,2020-04-17T17:00:00,ITA,20,39.21531192,9.110616306,113,23,136,736,872,7,14,220,86,1178,13304,,Sardegna,1653135,163
847,2020-04-18T17:00:00,ITA,20,39.21531192,9.110616306,112,23,135,746,881,9,20,231,86,1198,14087,,Sardegna,1653135,163
848,2020-04-19T17:00:00,ITA,20,39.21531192,9.110616306,117,22,139,725,864,-17,17,265,86,1215,14859,13760.0,Sardegna,1653135,163
849,2020-04-20T17:00:00,ITA,20,39.21531192,9.110616306,115,21,136,718,854,-10,13,288,86,1228,15328,14160.0,Sardegna,1653135,163
850,2020-04-21T17:00:00,ITA,20,39.21531192,9.110616306,112,21,133,704,837,-17,8,306,93,1236,15886,14526.0,Sardegna,1653135,163
851,2020-04-22T17:00:00,ITA,20,39.21531192,9.110616306,97,20,117,716,833,-4,11,318,96,1247,16886,15354.0,Sardegna,1653135,163
852,2020-04-23T17:00:00,ITA,20,39.21531192,9.110616306,90,20,110,707,817,-16,7,339,98,1254,17844,16094.0,Sardegna,1653135,163
853,2020-04-24T17:00:00,ITA,20,39.21531192,9.110616306,95,19,114,690,804,-13,3,351,102,1257,19889,18050.0,Sardegna,1653135,163
854,2020-02-24T18:00:00,ITA,19,38.11569725,13.362356699999998,0,0,0,0,0,0,0,0,0,0,5,,Sicilia,5056641,611
855,2020-02-25T18:00:00,ITA,19,38.11569725,13.362356699999998,1,0,1,2,3,3,3,0,0,3,5,,Sicilia,5056641,611
856,2020-02-26T18:00:00,ITA,19,38.11569725,13.362356699999998,1,0,1,2,3,0,0,0,0,3,5,,Sicilia,5056641,611
857,2020-02-27T18:00:00,ITA,19,38.11569725,13.362356699999998,1,0,1,1,2,-1,1,2,0,4,5,,Sicilia,5056641,611
858,2020-02-28T18:00:00,ITA,19,38.11569725,13.362356699999998,1,0,1,1,2,0,0,2,0,4,5,,Sicilia,5056641,611
859,2020-02-29T17:00:00,ITA,19,38.11569725,13.362356699999998,1,0,1,1,2,0,0,2,0,4,6,,Sicilia,5056641,611
860,2020-03-01T17:00:00,ITA,19,38.11569725,13.362356699999998,1,0,1,6,7,5,5,2,0,9,291,,Sicilia,5056641,611
861,2020-03-02T18:00:00,ITA,19,38.11569725,13.362356699999998,2,0,2,3,5,-2,-2,2,0,7,307,,Sicilia,5056641,611
862,2020-03-03T18:00:00,ITA,19,38.11569725,13.362356699999998,2,0,2,3,5,0,0,2,0,7,307,,Sicilia,5056641,611
863,2020-03-04T17:00:00,ITA,19,38.11569725,13.362356699999998,5,0,5,11,16,11,11,2,0,18,367,,Sicilia,5056641,611
864,2020-03-05T17:00:00,ITA,19,38.11569725,13.362356699999998,5,0,5,11,16,0,0,2,0,18,367,,Sicilia,5056641,611
865,2020-03-06T17:00:00,ITA,19,38.11569725,13.362356699999998,7,0,7,15,22,6,6,2,0,24,367,,Sicilia,5056641,611
866,2020-03-07T18:00:00,ITA,19,38.11569725,13.362356699999998,8,0,8,25,33,11,11,2,0,35,643,,Sicilia,5056641,611
867,2020-03-08T18:00:00,ITA,19,38.11569725,13.362356699999998,18,0,18,33,51,18,18,2,0,53,791,,Sicilia,5056641,611
868,2020-03-09T18:00:00,ITA,19,38.11569725,13.362356699999998,19,0,19,33,52,1,1,2,0,54,836,,Sicilia,5056641,611
869,2020-03-10T18:00:00,ITA,19,38.11569725,13.362356699999998,17,2,19,41,60,8,8,2,0,62,955,,Sicilia,5056641,611
870,2020-03-11T17:00:00,ITA,19,38.11569725,13.362356699999998,23,1,24,57,81,21,21,2,0,83,1194,,Sicilia,5056641,611
871,2020-03-12T17:00:00,ITA,19,38.11569725,13.362356699999998,28,5,33,78,111,30,32,2,2,115,1477,,Sicilia,5056641,611
872,2020-03-13T17:00:00,ITA,19,38.11569725,13.362356699999998,37,7,44,82,126,15,15,2,2,130,1950,,Sicilia,5056641,611
873,2020-03-14T17:00:00,ITA,19,38.11569725,13.362356699999998,42,11,53,97,150,24,26,4,2,156,2100,,Sicilia,5056641,611
874,2020-03-15T17:00:00,ITA,19,38.11569725,13.362356699999998,56,15,71,108,179,29,32,7,2,188,2452,,Sicilia,5056641,611
875,2020-03-16T17:00:00,ITA,19,38.11569725,13.362356699999998,75,20,95,108,203,24,25,8,2,213,2653,,Sicilia,5056641,611
876,2020-03-17T17:00:00,ITA,19,38.11569725,13.362356699999998,86,28,114,112,226,23,24,8,3,237,2916,,Sicilia,5056641,611
877,2020-03-18T17:00:00,ITA,19,38.11569725,13.362356699999998,100,29,129,138,267,41,45,12,3,282,3294,,Sicilia,5056641,611
878,2020-03-19T17:00:00,ITA,19,38.11569725,13.362356699999998,143,36,179,142,321,54,58,15,4,340,3961,,Sicilia,5056641,611
879,2020-03-20T17:00:00,ITA,19,38.11569725,13.362356699999998,168,42,210,169,379,58,68,25,4,408,4468,,Sicilia,5056641,611
880,2020-03-21T17:00:00,ITA,19,38.11569725,13.362356699999998,206,48,254,204,458,79,82,26,6,490,4883,,Sicilia,5056641,611
881,2020-03-22T17:00:00,ITA,19,38.11569725,13.362356699999998,220,55,275,321,596,138,140,26,8,630,5580,,Sicilia,5056641,611
882,2020-03-23T17:00:00,ITA,19,38.11569725,13.362356699999998,250,60,310,371,681,85,91,27,13,721,6375,,Sicilia,5056641,611
883,2020-03-24T17:00:00,ITA,19,38.11569725,13.362356699999998,250,60,310,489,799,118,125,27,20,846,7170,,Sicilia,5056641,611
884,2020-03-25T17:00:00,ITA,19,38.11569725,13.362356699999998,259,80,339,597,936,137,148,33,25,994,8312,,Sicilia,5056641,611
885,2020-03-26T17:00:00,ITA,19,38.11569725,13.362356699999998,346,68,414,681,1095,159,170,36,33,1164,9658,,Sicilia,5056641,611
886,2020-03-27T17:00:00,ITA,19,38.11569725,13.362356699999998,425,75,500,658,1158,63,86,53,39,1250,11079,,Sicilia,5056641,611
887,2020-03-28T17:00:00,ITA,19,38.11569725,13.362356699999998,441,71,512,730,1242,84,109,60,57,1359,13096,,Sicilia,5056641,611
888,2020-03-29T17:00:00,ITA,19,38.11569725,13.362356699999998,451,71,522,808,1330,88,101,65,65,1460,13814,,Sicilia,5056641,611
889,2020-03-30T17:00:00,ITA,19,38.11569725,13.362356699999998,484,75,559,849,1408,78,95,71,76,1555,14758,,Sicilia,5056641,611
890,2020-03-31T17:00:00,ITA,19,38.11569725,13.362356699999998,503,72,575,917,1492,84,92,74,81,1647,15634,,Sicilia,5056641,611
891,2020-04-01T17:00:00,ITA,19,38.11569725,13.362356699999998,496,72,568,976,1544,52,71,86,88,1718,16836,,Sicilia,5056641,611
892,2020-04-02T17:00:00,ITA,19,38.11569725,13.362356699999998,503,73,576,1030,1606,62,73,92,93,1791,17833,,Sicilia,5056641,611
893,2020-04-03T17:00:00,ITA,19,38.11569725,13.362356699999998,535,73,608,1056,1664,58,68,94,101,1859,18686,,Sicilia,5056641,611
894,2020-04-04T17:00:00,ITA,19,38.11569725,13.362356699999998,553,74,627,1099,1726,62,73,95,111,1932,19896,,Sicilia,5056641,611
895,2020-04-05T17:00:00,ITA,19,38.11569725,13.362356699999998,556,76,632,1142,1774,48,62,104,116,1994,21904,,Sicilia,5056641,611
896,2020-04-06T17:00:00,ITA,19,38.11569725,13.362356699999998,563,74,637,1178,1815,41,52,108,123,2046,23464,,Sicilia,5056641,611
897,2020-04-07T17:00:00,ITA,19,38.11569725,13.362356699999998,562,73,635,1224,1859,44,51,113,125,2097,24857,,Sicilia,5056641,611
898,2020-04-08T17:00:00,ITA,19,38.11569725,13.362356699999998,563,65,628,1265,1893,34,62,133,133,2159,27438,,Sicilia,5056641,611
899,2020-04-09T17:00:00,ITA,19,38.11569725,13.362356699999998,566,63,629,1313,1942,49,73,152,138,2232,28742,,Sicilia,5056641,611
900,2020-04-10T17:00:00,ITA,19,38.11569725,13.362356699999998,568,62,630,1337,1967,25,70,187,148,2302,31156,,Sicilia,5056641,611
901,2020-04-11T17:00:00,ITA,19,38.11569725,13.362356699999998,562,58,620,1381,2001,34,62,209,154,2364,33787,,Sicilia,5056641,611
902,2020-04-12T17:00:00,ITA,19,38.11569725,13.362356699999998,552,53,605,1425,2030,29,52,223,163,2416,36098,,Sicilia,5056641,611
903,2020-04-13T17:00:00,ITA,19,38.11569725,13.362356699999998,554,51,605,1445,2050,20,42,237,171,2458,37311,,Sicilia,5056641,611
904,2020-04-14T17:00:00,ITA,19,38.11569725,13.362356699999998,552,53,605,1466,2071,21,43,255,175,2501,37877,,Sicilia,5056641,611
905,2020-04-15T17:00:00,ITA,19,38.11569725,13.362356699999998,541,49,590,1491,2081,10,34,273,181,2535,39867,,Sicilia,5056641,611
906,2020-04-16T17:00:00,ITA,19,38.11569725,13.362356699999998,525,48,573,1535,2108,27,44,284,187,2579,42405,,Sicilia,5056641,611
907,2020-04-17T17:00:00,ITA,19,38.11569725,13.362356699999998,521,46,567,1572,2139,31,46,296,190,2625,45172,,Sicilia,5056641,611
908,2020-04-18T17:00:00,ITA,19,38.11569725,13.362356699999998,526,42,568,1603,2171,32,47,305,196,2672,47715,,Sicilia,5056641,611
909,2020-04-19T17:00:00,ITA,19,38.11569725,13.362356699999998,522,41,563,1639,2202,31,45,315,200,2717,49772,49772.0,Sicilia,5056641,611
910,2020-04-20T17:00:00,ITA,19,38.11569725,13.362356699999998,526,39,565,1645,2210,8,42,346,203,2759,51373,51373.0,Sicilia,5056641,611
911,2020-04-21T17:00:00,ITA,19,38.11569725,13.362356699999998,514,37,551,1708,2259,49,76,370,206,2835,55093,55093.0,Sicilia,5056641,611
912,2020-04-22T17:00:00,ITA,19,38.11569725,13.362356699999998,500,35,535,1752,2287,28,48,388,208,2883,58732,58732.0,Sicilia,5056641,611
913,2020-04-23T17:00:00,ITA,19,38.11569725,13.362356699999998,476,34,510,1791,2301,14,43,412,213,2926,62150,62150.0,Sicilia,5056641,611
914,2020-04-24T17:00:00,ITA,19,38.11569725,13.362356699999998,461,32,493,1827,2320,19,55,443,218,2981,65165,63626.0,Sicilia,5056641,611
915,2020-02-24T18:00:00,ITA,9,43.76923077,11.25588885,0,0,0,0,0,0,0,0,0,0,140,,Toscana,3742437,650
916,2020-02-25T18:00:00,ITA,9,43.76923077,11.25588885,2,0,2,0,2,2,2,0,0,2,296,,Toscana,3742437,650
917,2020-02-26T18:00:00,ITA,9,43.76923077,11.25588885,2,0,2,0,2,0,0,0,0,2,363,,Toscana,3742437,650
918,2020-02-27T18:00:00,ITA,9,43.76923077,11.25588885,2,0,2,0,2,0,0,0,0,2,410,,Toscana,3742437,650
919,2020-02-28T18:00:00,ITA,9,43.76923077,11.25588885,5,0,5,2,7,5,6,1,0,8,437,,Toscana,3742437,650
920,2020-02-29T17:00:00,ITA,9,43.76923077,11.25588885,7,0,7,3,10,3,3,1,0,11,531,,Toscana,3742437,650
921,2020-03-01T17:00:00,ITA,9,43.76923077,11.25588885,7,0,7,5,12,2,2,1,0,13,572,,Toscana,3742437,650
922,2020-03-02T18:00:00,ITA,9,43.76923077,11.25588885,7,0,7,5,12,0,0,1,0,13,613,,Toscana,3742437,650
923,2020-03-03T18:00:00,ITA,9,43.76923077,11.25588885,10,0,10,8,18,6,6,1,0,19,697,,Toscana,3742437,650
924,2020-03-04T17:00:00,ITA,9,43.76923077,11.25588885,15,2,17,20,37,19,19,1,0,38,776,,Toscana,3742437,650
925,2020-03-05T17:00:00,ITA,9,43.76923077,11.25588885,26,3,29,31,60,23,23,1,0,61,776,,Toscana,3742437,650
926,2020-03-06T17:00:00,ITA,9,43.76923077,11.25588885,35,5,40,38,78,18,18,1,0,79,1097,,Toscana,3742437,650
927,2020-03-07T18:00:00,ITA,9,43.76923077,11.25588885,54,7,61,51,112,34,34,1,0,113,1331,,Toscana,3742437,650
928,2020-03-08T18:00:00,ITA,9,43.76923077,11.25588885,91,7,98,67,165,53,53,1,0,166,1618,,Toscana,3742437,650
929,2020-03-09T18:00:00,ITA,9,43.76923077,11.25588885,107,9,116,90,206,41,42,1,1,208,2018,,Toscana,3742437,650
930,2020-03-10T18:00:00,ITA,9,43.76923077,11.25588885,91,40,131,129,260,54,56,3,1,264,2573,,Toscana,3742437,650
931,2020-03-11T17:00:00,ITA,9,43.76923077,11.25588885,87,54,141,173,314,54,56,5,1,320,2804,,Toscana,3742437,650
932,2020-03-12T17:00:00,ITA,9,43.76923077,11.25588885,100,59,159,193,352,38,44,7,5,364,3165,,Toscana,3742437,650
933,2020-03-13T17:00:00,ITA,9,43.76923077,11.25588885,134,77,211,244,455,103,106,10,5,470,4049,,Toscana,3742437,650
934,2020-03-14T17:00:00,ITA,9,43.76923077,11.25588885,160,87,247,367,614,159,160,10,6,630,4595,,Toscana,3742437,650
935,2020-03-15T17:00:00,ITA,9,43.76923077,11.25588885,175,107,282,481,763,149,151,10,8,781,5132,,Toscana,3742437,650
936,2020-03-16T17:00:00,ITA,9,43.76923077,11.25588885,175,107,282,559,841,78,85,11,14,866,5910,,Toscana,3742437,650
937,2020-03-17T17:00:00,ITA,9,43.76923077,11.25588885,329,143,472,552,1024,183,187,12,17,1053,6727,,Toscana,3742437,650
938,2020-03-18T17:00:00,ITA,9,43.76923077,11.25588885,427,160,587,704,1291,267,277,17,22,1330,7606,,Toscana,3742437,650
939,2020-03-19T17:00:00,ITA,9,43.76923077,11.25588885,501,178,679,743,1422,131,152,22,38,1482,8873,,Toscana,3742437,650
940,2020-03-20T17:00:00,ITA,9,43.76923077,11.25588885,601,189,790,923,1713,291,311,33,47,1793,10405,,Toscana,3742437,650
941,2020-03-21T17:00:00,ITA,9,43.76923077,11.25588885,664,202,866,1039,1905,192,219,35,72,2012,11909,,Toscana,3742437,650
942,2020-03-22T17:00:00,ITA,9,43.76923077,11.25588885,706,215,921,1223,2144,239,265,42,91,2277,13264,,Toscana,3742437,650
943,2020-03-23T17:00:00,ITA,9,43.76923077,11.25588885,838,238,1076,1225,2301,157,184,51,109,2461,13851,,Toscana,3742437,650
944,2020-03-24T17:00:00,ITA,9,43.76923077,11.25588885,918,244,1162,1357,2519,218,238,51,129,2699,15701,,Toscana,3742437,650
945,2020-03-25T17:00:00,ITA,9,43.76923077,11.25588885,999,251,1250,1526,2776,257,273,54,142,2972,17868,,Toscana,3742437,650
946,2020-03-26T17:00:00,ITA,9,43.76923077,11.25588885,1037,259,1296,1677,2973,197,254,95,158,3226,20952,,Toscana,3742437,650
947,2020-03-27T17:00:00,ITA,9,43.76923077,11.25588885,1053,274,1327,1843,3170,197,224,103,177,3450,23746,,Toscana,3742437,650
948,2020-03-28T17:00:00,ITA,9,43.76923077,11.25588885,1093,277,1370,2141,3511,341,367,108,198,3817,25613,,Toscana,3742437,650
949,2020-03-29T17:00:00,ITA,9,43.76923077,11.25588885,1111,275,1386,2400,3786,275,305,121,215,4122,27579,,Toscana,3742437,650
950,2020-03-30T17:00:00,ITA,9,43.76923077,11.25588885,1116,279,1395,2655,4050,264,290,131,231,4412,30099,,Toscana,3742437,650
951,2020-03-31T17:00:00,ITA,9,43.76923077,11.25588885,1120,293,1413,2813,4226,176,196,138,244,4608,33165,,Toscana,3742437,650
952,2020-04-01T17:00:00,ITA,9,43.76923077,11.25588885,1120,297,1417,3015,4432,206,259,182,253,4867,36575,,Toscana,3742437,650
953,2020-04-02T17:00:00,ITA,9,43.76923077,11.25588885,1135,295,1430,3359,4789,357,406,216,268,5273,40724,,Toscana,3742437,650
954,2020-04-03T17:00:00,ITA,9,43.76923077,11.25588885,1149,288,1437,3472,4909,120,226,300,290,5499,44460,,Toscana,3742437,650
955,2020-04-04T17:00:00,ITA,9,43.76923077,11.25588885,1129,286,1415,3639,5054,145,172,310,307,5671,47886,,Toscana,3742437,650
956,2020-04-05T17:00:00,ITA,9,43.76923077,11.25588885,1111,276,1387,3798,5185,131,176,337,325,5847,51006,,Toscana,3742437,650
957,2020-04-06T17:00:00,ITA,9,43.76923077,11.25588885,1116,279,1395,3906,5301,116,154,350,350,6001,52849,,Toscana,3742437,650
958,2020-04-07T17:00:00,ITA,9,43.76923077,11.25588885,1087,263,1350,4077,5427,126,172,377,369,6173,56651,,Toscana,3742437,650
959,2020-04-08T17:00:00,ITA,9,43.76923077,11.25588885,1066,260,1326,4231,5557,130,206,430,392,6379,60985,,Toscana,3742437,650
960,2020-04-09T17:00:00,ITA,9,43.76923077,11.25588885,1038,256,1294,4409,5703,146,173,441,408,6552,65461,,Toscana,3742437,650
961,2020-04-10T17:00:00,ITA,9,43.76923077,11.25588885,1011,256,1267,4555,5822,119,175,451,454,6727,72001,,Toscana,3742437,650
962,2020-04-11T17:00:00,ITA,9,43.76923077,11.25588885,997,237,1234,4758,5992,170,231,499,467,6958,75756,,Toscana,3742437,650
963,2020-04-12T17:00:00,ITA,9,43.76923077,11.25588885,983,238,1221,4941,6162,170,277,578,495,7235,78640,,Toscana,3742437,650
964,2020-04-13T17:00:00,ITA,9,43.76923077,11.25588885,992,225,1217,5040,6257,95,155,615,518,7390,80889,,Toscana,3742437,650
965,2020-04-14T17:00:00,ITA,9,43.76923077,11.25588885,1002,225,1227,5125,6352,95,137,637,538,7527,82269,,Toscana,3742437,650
966,2020-04-15T17:00:00,ITA,9,43.76923077,11.25588885,977,216,1193,5224,6417,65,139,693,556,7666,86348,,Toscana,3742437,650
967,2020-04-16T17:00:00,ITA,9,43.76923077,11.25588885,940,213,1153,5460,6613,196,277,745,585,7943,91651,,Toscana,3742437,650
968,2020-04-17T17:00:00,ITA,9,43.76923077,11.25588885,898,207,1105,5478,6583,-30,167,925,602,8110,96231,,Toscana,3742437,650
969,2020-04-18T17:00:00,ITA,9,43.76923077,11.25588885,883,198,1081,5389,6470,-113,127,1149,618,8237,99903,,Toscana,3742437,650
970,2020-04-19T17:00:00,ITA,9,43.76923077,11.25588885,852,192,1044,5452,6496,26,135,1239,637,8372,103975,84620.0,Toscana,3742437,650
971,2020-04-20T17:00:00,ITA,9,43.76923077,11.25588885,850,182,1032,5536,6568,72,135,1272,667,8507,105857,85946.0,Toscana,3742437,650
972,2020-04-21T17:00:00,ITA,9,43.76923077,11.25588885,833,171,1004,5618,6622,54,96,1295,686,8603,109925,87717.0,Toscana,3742437,650
973,2020-04-22T17:00:00,ITA,9,43.76923077,11.25588885,820,174,994,5173,6167,-455,97,1828,705,8700,114100,91747.0,Toscana,3742437,650
974,2020-04-23T17:00:00,ITA,9,43.76923077,11.25588885,791,168,959,5212,6171,4,80,1886,723,8780,118177,94426.0,Toscana,3742437,650
975,2020-04-24T17:00:00,ITA,9,43.76923077,11.25588885,738,159,897,5236,6133,-38,97,2002,742,8877,121336,96180.0,Toscana,3742437,650
976,2020-02-24T18:00:00,ITA,10,43.10675841,12.38824698,0,0,0,0,0,0,0,0,0,0,0,,Umbria,888908,96
977,2020-02-25T18:00:00,ITA,10,43.10675841,12.38824698,0,0,0,0,0,0,0,0,0,0,8,,Umbria,888908,96
978,2020-02-26T18:00:00,ITA,10,43.10675841,12.38824698,0,0,0,0,0,0,0,0,0,0,8,,Umbria,888908,96
979,2020-02-27T18:00:00,ITA,10,43.10675841,12.38824698,0,0,0,0,0,0,0,0,0,0,8,,Umbria,888908,96
980,2020-02-28T18:00:00,ITA,10,43.10675841,12.38824698,0,0,0,0,0,0,0,0,0,0,8,,Umbria,888908,96
981,2020-02-29T17:00:00,ITA,10,43.10675841,12.38824698,0,0,0,0,0,0,0,0,0,0,31,,Umbria,888908,96
982,2020-03-01T17:00:00,ITA,10,43.10675841,12.38824698,0,0,0,2,2,2,2,0,0,2,35,,Umbria,888908,96
983,2020-03-02T18:00:00,ITA,10,43.10675841,12.38824698,0,0,0,2,2,0,0,0,0,2,35,,Umbria,888908,96
984,2020-03-03T18:00:00,ITA,10,43.10675841,12.38824698,1,1,2,6,8,6,6,0,0,8,45,,Umbria,888908,96
985,2020-03-04T17:00:00,ITA,10,43.10675841,12.38824698,1,1,2,7,9,1,1,0,0,9,58,,Umbria,888908,96
986,2020-03-05T17:00:00,ITA,10,43.10675841,12.38824698,1,1,2,7,9,0,0,0,0,9,88,,Umbria,888908,96
987,2020-03-06T17:00:00,ITA,10,43.10675841,12.38824698,2,2,4,12,16,7,7,0,0,16,110,,Umbria,888908,96
988,2020-03-07T18:00:00,ITA,10,43.10675841,12.38824698,2,2,4,20,24,8,8,0,0,24,134,,Umbria,888908,96
989,2020-03-08T18:00:00,ITA,10,43.10675841,12.38824698,2,2,4,22,26,2,2,0,0,26,168,,Umbria,888908,96
990,2020-03-09T18:00:00,ITA,10,43.10675841,12.38824698,4,2,6,22,28,2,2,0,0,28,183,,Umbria,888908,96
991,2020-03-10T18:00:00,ITA,10,43.10675841,12.38824698,8,2,10,27,37,9,9,0,0,37,260,,Umbria,888908,96
992,2020-03-11T17:00:00,ITA,10,43.10675841,12.38824698,7,5,12,32,44,7,9,2,0,46,340,,Umbria,888908,96
993,2020-03-12T17:00:00,ITA,10,43.10675841,12.38824698,8,8,16,46,62,18,18,2,0,64,458,,Umbria,888908,96
994,2020-03-13T17:00:00,ITA,10,43.10675841,12.38824698,11,10,21,52,73,11,12,2,1,76,576,,Umbria,888908,96
995,2020-03-14T17:00:00,ITA,10,43.10675841,12.38824698,21,11,32,71,103,30,31,3,1,107,748,,Umbria,888908,96
996,2020-03-15T17:00:00,ITA,10,43.10675841,12.38824698,25,13,38,101,139,36,36,3,1,143,965,,Umbria,888908,96
997,2020-03-16T17:00:00,ITA,10,43.10675841,12.38824698,30,15,45,114,159,20,21,4,1,164,1093,,Umbria,888908,96
998,2020-03-17T17:00:00,ITA,10,43.10675841,12.38824698,36,21,57,135,192,33,33,4,1,197,1323,,Umbria,888908,96
999,2020-03-18T17:00:00,ITA,10,43.10675841,12.38824698,54,21,75,166,241,49,50,4,2,247,1601,,Umbria,888908,96
1000,2020-03-19T17:00:00,ITA,10,43.10675841,12.38824698,69,21,90,238,328,87,87,4,2,334,1954,,Umbria,888908,96
1001,2020-03-20T17:00:00,ITA,10,43.10675841,12.38824698,75,24,99,285,384,56,61,4,7,395,2303,,Umbria,888908,96
1002,2020-03-21T17:00:00,ITA,10,43.10675841,12.38824698,92,29,121,326,447,63,67,5,10,462,2712,,Umbria,888908,96
1003,2020-03-22T17:00:00,ITA,10,43.10675841,12.38824698,97,35,132,368,500,53,59,5,16,521,3135,,Umbria,888908,96
1004,2020-03-23T17:00:00,ITA,10,43.10675841,12.38824698,106,42,148,408,556,56,56,5,16,577,3561,,Umbria,888908,96
1005,2020-03-24T17:00:00,ITA,10,43.10675841,12.38824698,105,43,148,476,624,68,71,5,19,648,4108,,Umbria,888908,96
1006,2020-03-25T17:00:00,ITA,10,43.10675841,12.38824698,123,44,167,519,686,62,62,5,19,710,4707,,Umbria,888908,96
1007,2020-03-26T17:00:00,ITA,10,43.10675841,12.38824698,144,46,190,580,770,84,92,12,20,802,5428,,Umbria,888908,96
1008,2020-03-27T17:00:00,ITA,10,43.10675841,12.38824698,149,46,195,629,824,54,82,39,21,884,6137,,Umbria,888908,96
1009,2020-03-28T17:00:00,ITA,10,43.10675841,12.38824698,159,44,203,695,898,74,85,43,28,969,7028,,Umbria,888908,96
1010,2020-03-29T17:00:00,ITA,10,43.10675841,12.38824698,166,46,212,685,897,-1,54,95,31,1023,7685,,Umbria,888908,96
1011,2020-03-30T17:00:00,ITA,10,43.10675841,12.38824698,173,47,220,614,834,-63,28,184,33,1051,8150,,Umbria,888908,96
1012,2020-03-31T17:00:00,ITA,10,43.10675841,12.38824698,176,43,219,632,851,17,27,190,37,1078,8685,,Umbria,888908,96
1013,2020-04-01T17:00:00,ITA,10,43.10675841,12.38824698,173,45,218,646,864,13,17,194,37,1095,9080,,Umbria,888908,96
1014,2020-04-02T17:00:00,ITA,10,43.10675841,12.38824698,171,47,218,667,885,21,33,205,38,1128,9737,,Umbria,888908,96
1015,2020-04-03T17:00:00,ITA,10,43.10675841,12.38824698,165,48,213,707,920,35,51,220,39,1179,10614,,Umbria,888908,96
1016,2020-04-04T17:00:00,ITA,10,43.10675841,12.38824698,167,44,211,716,927,7,31,242,41,1210,11809,,Umbria,888908,96
1017,2020-04-05T17:00:00,ITA,10,43.10675841,12.38824698,159,45,204,694,898,-29,29,298,43,1239,12448,,Umbria,888908,96
1018,2020-04-06T17:00:00,ITA,10,43.10675841,12.38824698,159,46,205,667,872,-26,14,337,44,1253,12573,,Umbria,888908,96
1019,2020-04-07T17:00:00,ITA,10,43.10675841,12.38824698,157,41,198,648,846,-26,10,368,49,1263,13274,,Umbria,888908,96
1020,2020-04-08T17:00:00,ITA,10,43.10675841,12.38824698,155,41,196,627,823,-23,26,416,50,1289,14105,,Umbria,888908,96
1021,2020-04-09T17:00:00,ITA,10,43.10675841,12.38824698,154,38,192,600,792,-31,9,455,51,1298,15170,,Umbria,888908,96
1022,2020-04-10T17:00:00,ITA,10,43.10675841,12.38824698,146,39,185,567,752,-40,4,498,52,1302,16325,,Umbria,888908,96
1023,2020-04-11T17:00:00,ITA,10,43.10675841,12.38824698,137,39,176,547,723,-29,7,534,52,1309,17661,,Umbria,888908,96
1024,2020-04-12T17:00:00,ITA,10,43.10675841,12.38824698,129,39,168,519,687,-36,10,580,52,1319,18672,,Umbria,888908,96
1025,2020-04-13T17:00:00,ITA,10,43.10675841,12.38824698,127,38,165,460,625,-62,1,643,52,1320,18740,,Umbria,888908,96
1026,2020-04-14T17:00:00,ITA,10,43.10675841,12.38824698,127,37,164,458,622,-3,1,646,53,1321,18956,,Umbria,888908,96
1027,2020-04-15T17:00:00,ITA,10,43.10675841,12.38824698,122,37,159,423,582,-40,1,686,54,1322,20258,,Umbria,888908,96
1028,2020-04-16T17:00:00,ITA,10,43.10675841,12.38824698,116,33,149,387,536,-46,7,738,55,1329,21487,,Umbria,888908,96
1029,2020-04-17T17:00:00,ITA,10,43.10675841,12.38824698,111,31,142,352,494,-42,8,786,57,1337,22818,,Umbria,888908,96
1030,2020-04-18T17:00:00,ITA,10,43.10675841,12.38824698,109,32,141,290,431,-63,7,856,57,1344,24106,,Umbria,888908,96
1031,2020-04-19T17:00:00,ITA,10,43.10675841,12.38824698,108,30,138,298,436,5,4,854,58,1348,25170,16790.0,Umbria,888908,96
1032,2020-04-20T17:00:00,ITA,10,43.10675841,12.38824698,113,29,142,282,424,-12,1,867,58,1349,25562,17099.0,Umbria,888908,96
1033,2020-04-21T17:00:00,ITA,10,43.10675841,12.38824698,107,22,129,278,407,-17,4,886,60,1353,26639,17873.0,Umbria,888908,96
1034,2020-04-22T17:00:00,ITA,10,43.10675841,12.38824698,97,20,117,254,371,-36,4,925,61,1357,27655,18679.0,Umbria,888908,96
1035,2020-04-23T17:00:00,ITA,10,43.10675841,12.38824698,100,19,119,236,355,-16,5,946,61,1362,29011,19627.0,Umbria,888908,96
1036,2020-04-24T17:00:00,ITA,10,43.10675841,12.38824698,94,19,113,209,322,-33,1,979,62,1363,30524,20733.0,Umbria,888908,96
1037,2020-02-24T18:00:00,ITA,2,45.73750286,7.320149366,0,0,0,0,0,0,0,0,0,0,7,,Valle d'Aosta,126883,25
1038,2020-02-25T18:00:00,ITA,2,45.73750286,7.320149366,0,0,0,0,0,0,0,0,0,0,7,,Valle d'Aosta,126883,25
1039,2020-02-26T18:00:00,ITA,2,45.73750286,7.320149366,0,0,0,0,0,0,0,0,0,0,7,,Valle d'Aosta,126883,25
1040,2020-02-27T18:00:00,ITA,2,45.73750286,7.320149366,0,0,0,0,0,0,0,0,0,0,9,,Valle d'Aosta,126883,25
1041,2020-02-28T18:00:00,ITA,2,45.73750286,7.320149366,0,0,0,0,0,0,0,0,0,0,9,,Valle d'Aosta,126883,25
1042,2020-02-29T17:00:00,ITA,2,45.73750286,7.320149366,0,0,0,0,0,0,0,0,0,0,9,,Valle d'Aosta,126883,25
1043,2020-03-01T17:00:00,ITA,2,45.73750286,7.320149366,0,0,0,0,0,0,0,0,0,0,10,,Valle d'Aosta,126883,25
1044,2020-03-02T18:00:00,ITA,2,45.73750286,7.320149366,0,0,0,0,0,0,0,0,0,0,11,,Valle d'Aosta,126883,25
1045,2020-03-03T18:00:00,ITA,2,45.73750286,7.320149366,0,0,0,0,0,0,0,0,0,0,12,,Valle d'Aosta,126883,25
1046,2020-03-04T17:00:00,ITA,2,45.73750286,7.320149366,0,0,0,0,0,0,0,0,0,0,15,,Valle d'Aosta,126883,25
1047,2020-03-05T17:00:00,ITA,2,45.73750286,7.320149366,0,0,0,2,2,2,2,0,0,2,21,,Valle d'Aosta,126883,25
1048,2020-03-06T17:00:00,ITA,2,45.73750286,7.320149366,0,0,0,7,7,5,5,0,0,7,28,,Valle d'Aosta,126883,25
1049,2020-03-07T18:00:00,ITA,2,45.73750286,7.320149366,1,0,1,7,8,1,1,0,0,8,32,,Valle d'Aosta,126883,25
1050,2020-03-08T18:00:00,ITA,2,45.73750286,7.320149366,1,0,1,8,9,1,1,0,0,9,41,,Valle d'Aosta,126883,25
1051,2020-03-09T18:00:00,ITA,2,45.73750286,7.320149366,4,0,4,11,15,6,6,0,0,15,67,,Valle d'Aosta,126883,25
1052,2020-03-10T18:00:00,ITA,2,45.73750286,7.320149366,2,0,2,15,17,2,2,0,0,17,89,,Valle d'Aosta,126883,25
1053,2020-03-11T17:00:00,ITA,2,45.73750286,7.320149366,2,0,2,17,19,2,3,0,1,20,99,,Valle d'Aosta,126883,25
1054,2020-03-12T17:00:00,ITA,2,45.73750286,7.320149366,7,0,7,19,26,7,7,0,1,27,118,,Valle d'Aosta,126883,25
1055,2020-03-13T17:00:00,ITA,2,45.73750286,7.320149366,6,0,6,21,27,1,1,0,1,28,189,,Valle d'Aosta,126883,25
1056,2020-03-14T17:00:00,ITA,2,45.73750286,7.320149366,12,0,12,29,41,14,14,0,1,42,231,,Valle d'Aosta,126883,25
1057,2020-03-15T17:00:00,ITA,2,45.73750286,7.320149366,10,3,13,43,56,15,15,0,1,57,230,,Valle d'Aosta,126883,25
1058,2020-03-16T17:00:00,ITA,2,45.73750286,7.320149366,28,5,33,70,103,47,48,0,2,105,287,,Valle d'Aosta,126883,25
1059,2020-03-17T17:00:00,ITA,2,45.73750286,7.320149366,35,6,41,93,134,31,31,0,2,136,398,,Valle d'Aosta,126883,25
1060,2020-03-18T17:00:00,ITA,2,45.73750286,7.320149366,41,3,44,118,162,28,29,0,3,165,486,,Valle d'Aosta,126883,25
1061,2020-03-19T17:00:00,ITA,2,45.73750286,7.320149366,47,9,56,153,209,47,50,0,6,215,608,,Valle d'Aosta,126883,25
1062,2020-03-20T17:00:00,ITA,2,45.73750286,7.320149366,54,9,63,194,257,48,49,0,7,264,814,,Valle d'Aosta,126883,25
1063,2020-03-21T17:00:00,ITA,2,45.73750286,7.320149366,62,15,77,227,304,47,49,1,8,313,884,,Valle d'Aosta,126883,25
1064,2020-03-22T17:00:00,ITA,2,45.73750286,7.320149366,63,21,84,270,354,50,51,1,9,364,950,,Valle d'Aosta,126883,25
1065,2020-03-23T17:00:00,ITA,2,45.73750286,7.320149366,69,20,89,290,379,25,29,2,12,393,1098,,Valle d'Aosta,126883,25
1066,2020-03-24T17:00:00,ITA,2,45.73750286,7.320149366,71,20,91,288,379,0,7,2,19,400,1180,,Valle d'Aosta,126883,25
1067,2020-03-25T17:00:00,ITA,2,45.73750286,7.320149366,70,25,95,280,375,-4,1,2,24,401,1200,,Valle d'Aosta,126883,25
1068,2020-03-26T17:00:00,ITA,2,45.73750286,7.320149366,73,24,97,281,378,3,7,2,28,408,1203,,Valle d'Aosta,126883,25
1069,2020-03-27T17:00:00,ITA,2,45.73750286,7.320149366,91,24,115,298,413,35,44,2,37,452,1252,,Valle d'Aosta,126883,25
1070,2020-03-28T17:00:00,ITA,2,45.73750286,7.320149366,90,26,116,352,468,55,59,2,41,511,1380,,Valle d'Aosta,126883,25
1071,2020-03-29T17:00:00,ITA,2,45.73750286,7.320149366,90,26,116,423,539,71,73,2,43,584,1480,,Valle d'Aosta,126883,25
1072,2020-03-30T17:00:00,ITA,2,45.73750286,7.320149366,92,26,118,400,518,-21,0,16,50,584,1536,,Valle d'Aosta,126883,25
1073,2020-03-31T17:00:00,ITA,2,45.73750286,7.320149366,91,26,117,435,552,34,44,20,56,628,1582,,Valle d'Aosta,126883,25
1074,2020-04-01T17:00:00,ITA,2,45.73750286,7.320149366,85,27,112,428,540,-12,3,32,59,631,1717,,Valle d'Aosta,126883,25
1075,2020-04-02T17:00:00,ITA,2,45.73750286,7.320149366,85,25,110,446,556,16,37,49,63,668,1934,,Valle d'Aosta,126883,25
1076,2020-04-03T17:00:00,ITA,2,45.73750286,7.320149366,85,25,110,450,560,4,51,89,70,719,2106,,Valle d'Aosta,126883,25
1077,2020-04-04T17:00:00,ITA,2,45.73750286,7.320149366,63,23,86,474,560,0,29,106,82,748,2274,,Valle d'Aosta,126883,25
1078,2020-04-05T17:00:00,ITA,2,45.73750286,7.320149366,96,23,119,457,576,16,34,115,91,782,2390,,Valle d'Aosta,126883,25
1079,2020-04-06T17:00:00,ITA,2,45.73750286,7.320149366,109,21,130,437,567,-9,23,142,96,805,2590,,Valle d'Aosta,126883,25
1080,2020-04-07T17:00:00,ITA,2,45.73750286,7.320149366,118,17,135,458,593,26,30,142,100,835,2754,,Valle d'Aosta,126883,25
1081,2020-04-08T17:00:00,ITA,2,45.73750286,7.320149366,120,20,140,466,606,13,15,142,102,850,2953,,Valle d'Aosta,126883,25
1082,2020-04-09T17:00:00,ITA,2,45.73750286,7.320149366,118,18,136,473,609,3,18,154,105,868,3142,,Valle d'Aosta,126883,25
1083,2020-04-10T17:00:00,ITA,2,45.73750286,7.320149366,131,16,147,455,602,-7,11,170,107,879,3328,,Valle d'Aosta,126883,25
1084,2020-04-11T17:00:00,ITA,2,45.73750286,7.320149366,118,17,135,455,590,-12,23,205,107,902,3464,,Valle d'Aosta,126883,25
1085,2020-04-12T17:00:00,ITA,2,45.73750286,7.320149366,109,16,125,463,588,-2,19,221,112,921,3510,,Valle d'Aosta,126883,25
1086,2020-04-13T17:00:00,ITA,2,45.73750286,7.320149366,109,15,124,458,582,-6,6,230,115,927,3614,,Valle d'Aosta,126883,25
1087,2020-04-14T17:00:00,ITA,2,45.73750286,7.320149366,112,14,126,433,559,-23,20,270,118,947,3726,,Valle d'Aosta,126883,25
1088,2020-04-15T17:00:00,ITA,2,45.73750286,7.320149366,112,11,123,425,548,-11,11,289,121,958,3894,,Valle d'Aosta,126883,25
1089,2020-04-16T17:00:00,ITA,2,45.73750286,7.320149366,105,12,117,401,518,-30,13,331,122,971,4159,,Valle d'Aosta,126883,25
1090,2020-04-17T17:00:00,ITA,2,45.73750286,7.320149366,108,9,117,374,491,-27,22,379,123,993,4366,,Valle d'Aosta,126883,25
1091,2020-04-18T17:00:00,ITA,2,45.73750286,7.320149366,107,10,117,432,549,58,80,400,124,1073,4521,,Valle d'Aosta,126883,25
1092,2020-04-19T17:00:00,ITA,2,45.73750286,7.320149366,102,10,112,450,562,13,15,401,125,1088,4677,3802.0,Valle d'Aosta,126883,25
1093,2020-04-20T17:00:00,ITA,2,45.73750286,7.320149366,102,8,110,438,548,-14,0,413,127,1088,4799,3910.0,Valle d'Aosta,126883,25
1094,2020-04-21T17:00:00,ITA,2,45.73750286,7.320149366,99,8,107,415,522,-26,5,445,126,1093,4911,3969.0,Valle d'Aosta,126883,25
1095,2020-04-22T17:00:00,ITA,2,45.73750286,7.320149366,92,8,100,401,501,-21,2,467,127,1095,5024,4011.0,Valle d'Aosta,126883,25
1096,2020-04-23T17:00:00,ITA,2,45.73750286,7.320149366,91,9,100,363,463,-38,1,506,127,1096,5227,4133.0,Valle d'Aosta,126883,25
1097,2020-04-24T17:00:00,ITA,2,45.73750286,7.320149366,88,7,95,259,354,-109,4,617,129,1100,5262,4454.0,Valle d'Aosta,126883,25
1098,2020-02-24T18:00:00,ITA,5,45.43490485,12.33845213,12,4,16,16,32,0,32,0,1,33,2200,,Veneto,4907529,825
1099,2020-02-25T18:00:00,ITA,5,45.43490485,12.33845213,12,7,19,23,42,10,10,0,1,43,3780,,Veneto,4907529,825
1100,2020-02-26T18:00:00,ITA,5,45.43490485,12.33845213,16,8,24,45,69,27,28,0,2,71,4900,,Veneto,4907529,825
1101,2020-02-27T18:00:00,ITA,5,45.43490485,12.33845213,19,8,27,82,109,40,40,0,2,111,6164,,Veneto,4907529,825
1102,2020-02-28T18:00:00,ITA,5,45.43490485,12.33845213,24,9,33,116,149,40,40,0,2,151,7414,,Veneto,4907529,825
1103,2020-02-29T17:00:00,ITA,5,45.43490485,12.33845213,24,11,35,154,189,40,40,0,2,191,8659,,Veneto,4907529,825
1104,2020-03-01T17:00:00,ITA,5,45.43490485,12.33845213,51,13,64,197,261,72,72,0,2,263,9056,,Veneto,4907529,825
1105,2020-03-02T18:00:00,ITA,5,45.43490485,12.33845213,53,14,67,204,271,10,10,0,2,273,9782,,Veneto,4907529,825
1106,2020-03-03T18:00:00,ITA,5,45.43490485,12.33845213,49,19,68,229,297,26,34,7,3,307,10176,,Veneto,4907529,825
1107,2020-03-04T17:00:00,ITA,5,45.43490485,12.33845213,76,23,99,246,345,48,53,9,6,360,10515,,Veneto,4907529,825
1108,2020-03-05T17:00:00,ITA,5,45.43490485,12.33845213,92,24,116,264,380,35,47,17,10,407,11949,,Veneto,4907529,825
1109,2020-03-06T17:00:00,ITA,5,45.43490485,12.33845213,117,27,144,310,454,74,81,22,12,488,13023,,Veneto,4907529,825
1110,2020-03-07T18:00:00,ITA,5,45.43490485,12.33845213,123,41,164,341,505,51,55,25,13,543,14429,,Veneto,4907529,825
1111,2020-03-08T18:00:00,ITA,5,45.43490485,12.33845213,146,47,193,430,623,118,127,29,18,670,15918,,Veneto,4907529,825
1112,2020-03-09T18:00:00,ITA,5,45.43490485,12.33845213,186,51,237,457,694,71,74,30,20,744,15956,,Veneto,4907529,825
1113,2020-03-10T18:00:00,ITA,5,45.43490485,12.33845213,204,67,271,512,783,89,112,47,26,856,16643,,Veneto,4907529,825
1114,2020-03-11T17:00:00,ITA,5,45.43490485,12.33845213,262,68,330,610,940,157,167,54,29,1023,21400,,Veneto,4907529,825
1115,2020-03-12T17:00:00,ITA,5,45.43490485,12.33845213,360,85,445,852,1297,357,361,55,32,1384,23438,,Veneto,4907529,825
1116,2020-03-13T17:00:00,ITA,5,45.43490485,12.33845213,366,107,473,980,1453,156,211,100,42,1595,25691,,Veneto,4907529,825
1117,2020-03-14T17:00:00,ITA,5,45.43490485,12.33845213,366,119,485,1290,1775,322,342,107,55,1937,26980,,Veneto,4907529,825
1118,2020-03-15T17:00:00,ITA,5,45.43490485,12.33845213,426,129,555,1434,1989,214,235,120,63,2172,32546,,Veneto,4907529,825
1119,2020-03-16T17:00:00,ITA,5,45.43490485,12.33845213,498,156,654,1620,2274,285,301,130,69,2473,35052,,Veneto,4907529,825
1120,2020-03-17T17:00:00,ITA,5,45.43490485,12.33845213,548,171,719,1769,2488,214,231,136,80,2704,35478,,Veneto,4907529,825
1121,2020-03-18T17:00:00,ITA,5,45.43490485,12.33845213,646,195,841,2112,2953,465,510,167,94,3214,40841,,Veneto,4907529,825
1122,2020-03-19T17:00:00,ITA,5,45.43490485,12.33845213,771,209,980,2189,3169,216,270,200,115,3484,44658,,Veneto,4907529,825
1123,2020-03-20T17:00:00,ITA,5,45.43490485,12.33845213,843,236,1079,2598,3677,508,547,223,131,4031,49288,,Veneto,4907529,825
1124,2020-03-21T17:00:00,ITA,5,45.43490485,12.33845213,942,249,1191,3023,4214,537,586,257,146,4617,53642,,Veneto,4907529,825
1125,2020-03-22T17:00:00,ITA,5,45.43490485,12.33845213,1113,255,1368,3276,4644,430,505,309,169,5122,57671,,Veneto,4907529,825
1126,2020-03-23T17:00:00,ITA,5,45.43490485,12.33845213,1206,281,1487,3499,4986,342,383,327,192,5505,61115,,Veneto,4907529,825
1127,2020-03-24T17:00:00,ITA,5,45.43490485,12.33845213,1318,304,1622,3729,5351,365,443,381,216,5948,66178,,Veneto,4907529,825
1128,2020-03-25T17:00:00,ITA,5,45.43490485,12.33845213,1407,316,1723,4022,5745,394,494,439,258,6442,70877,,Veneto,4907529,825
1129,2020-03-26T17:00:00,ITA,5,45.43490485,12.33845213,1447,326,1773,4367,6140,395,493,508,287,6935,79759,,Veneto,4907529,825
1130,2020-03-27T17:00:00,ITA,5,45.43490485,12.33845213,1536,338,1874,4774,6648,508,562,536,313,7497,83627,,Veneto,4907529,825
1131,2020-03-28T17:00:00,ITA,5,45.43490485,12.33845213,1559,344,1903,5010,6913,265,433,655,362,7930,89380,,Veneto,4907529,825
1132,2020-03-29T17:00:00,ITA,5,45.43490485,12.33845213,1586,355,1941,5310,7251,338,428,715,392,8358,94784,,Veneto,4907529,825
1133,2020-03-30T17:00:00,ITA,5,45.43490485,12.33845213,1633,356,1989,5575,7564,313,366,747,413,8724,99941,,Veneto,4907529,825
1134,2020-03-31T17:00:00,ITA,5,45.43490485,12.33845213,1680,356,2036,5814,7850,286,431,828,477,9155,106238,,Veneto,4907529,825
1135,2020-04-01T17:00:00,ITA,5,45.43490485,12.33845213,1718,350,2068,6156,8224,374,470,902,499,9625,112746,,Veneto,4907529,825
1136,2020-04-02T17:00:00,ITA,5,45.43490485,12.33845213,1670,345,2015,6563,8578,354,486,1001,532,10111,120320,,Veneto,4907529,825
1137,2020-04-03T17:00:00,ITA,5,45.43490485,12.33845213,1714,335,2049,6812,8861,283,353,1031,572,10464,126490,,Veneto,4907529,825
1138,2020-04-04T17:00:00,ITA,5,45.43490485,12.33845213,1691,324,2015,7078,9093,232,360,1124,607,10824,133289,,Veneto,4907529,825
1139,2020-04-05T17:00:00,ITA,5,45.43490485,12.33845213,1674,329,2003,7406,9409,316,402,1186,631,11226,140910,,Veneto,4907529,825
1140,2020-04-06T17:00:00,ITA,5,45.43490485,12.33845213,1714,322,2036,7686,9722,313,362,1204,662,11588,146288,,Veneto,4907529,825
1141,2020-04-07T17:00:00,ITA,5,45.43490485,12.33845213,1579,297,1876,8089,9965,243,337,1265,695,11925,153542,,Veneto,4907529,825
1142,2020-04-08T17:00:00,ITA,5,45.43490485,12.33845213,1554,285,1839,8332,10171,206,485,1503,736,12410,163247,,Veneto,4907529,825
1143,2020-04-09T17:00:00,ITA,5,45.43490485,12.33845213,1530,274,1804,8645,10449,278,523,1728,756,12933,171456,,Veneto,4907529,825
1144,2020-04-10T17:00:00,ITA,5,45.43490485,12.33845213,1521,257,1778,8869,10647,198,488,1981,793,13421,180700,,Veneto,4907529,825
1145,2020-04-11T17:00:00,ITA,5,45.43490485,12.33845213,1465,251,1716,9033,10749,102,347,2188,831,13768,190912,,Veneto,4907529,825
1146,2020-04-12T17:00:00,ITA,5,45.43490485,12.33845213,1428,249,1677,9052,10729,-20,309,2492,856,14077,198442,,Veneto,4907529,825
1147,2020-04-13T17:00:00,ITA,5,45.43490485,12.33845213,1427,245,1672,9094,10766,37,174,2603,882,14251,203077,,Veneto,4907529,825
1148,2020-04-14T17:00:00,ITA,5,45.43490485,12.33845213,1427,233,1660,9076,10736,-30,181,2790,906,14432,208878,,Veneto,4907529,825
1149,2020-04-15T17:00:00,ITA,5,45.43490485,12.33845213,1402,219,1621,9168,10789,53,192,2895,940,14624,216344,,Veneto,4907529,825
1150,2020-04-16T17:00:00,ITA,5,45.43490485,12.33845213,1388,209,1597,9203,10800,11,366,3209,981,14990,224549,,Veneto,4907529,825
1151,2020-04-17T17:00:00,ITA,5,45.43490485,12.33845213,1359,197,1556,9062,10618,-182,384,3730,1026,15374,236722,,Veneto,4907529,825
1152,2020-04-18T17:00:00,ITA,5,45.43490485,12.33845213,1287,190,1477,8967,10444,-174,318,4189,1059,15692,247329,,Veneto,4907529,825
1153,2020-04-19T17:00:00,ITA,5,45.43490485,12.33845213,1264,184,1448,8762,10210,-234,243,4638,1087,15935,255797,161231.0,Veneto,4907529,825
1154,2020-04-20T17:00:00,ITA,5,45.43490485,12.33845213,1273,180,1453,8608,10061,-149,192,4954,1112,16127,260810,163757.0,Veneto,4907529,825
1155,2020-04-21T17:00:00,ITA,5,45.43490485,12.33845213,1230,177,1407,8670,10077,16,277,5173,1154,16404,268069,167129.0,Veneto,4907529,825
1156,2020-04-22T17:00:00,ITA,5,45.43490485,12.33845213,1205,163,1368,8623,9991,-86,334,5566,1181,16738,277543,171735.0,Veneto,4907529,825
1157,2020-04-23T17:00:00,ITA,5,45.43490485,12.33845213,1189,140,1329,8596,9925,-66,143,5750,1206,16881,288075,177154.0,Veneto,4907529,825
1158,2020-04-24T17:00:00,ITA,5,45.43490485,12.33845213,1159,130,1289,8390,9679,-246,348,6306,1244,17229,296896,181473.0,Veneto,4907529,825
1159,2020-02-24T18:00:00,ITA,8,46.068935,11.121231,0,0,0,0,0,0,0,0,0,0,4,0.0,Trentino Alto Adige,1059114,124
1160,2020-02-25T18:00:00,ITA,8,46.068935,11.121231,1,0,1,0,1,1,1,0,0,1,4,0.0,Trentino Alto Adige,1059114,124
1161,2020-02-26T18:00:00,ITA,8,46.068935,11.121231,1,0,1,0,1,0,0,0,0,1,4,0.0,Trentino Alto Adige,1059114,124
1162,2020-02-27T18:00:00,ITA,8,46.068935,11.121231,1,0,1,0,1,0,0,0,0,1,34,0.0,Trentino Alto Adige,1059114,124
1163,2020-02-28T18:00:00,ITA,8,46.068935,11.121231,1,0,1,0,1,0,0,0,0,1,34,0.0,Trentino Alto Adige,1059114,124
1164,2020-02-29T17:00:00,ITA,8,46.068935,11.121231,1,0,1,0,1,0,0,0,0,1,59,0.0,Trentino Alto Adige,1059114,124
1165,2020-03-01T17:00:00,ITA,8,46.068935,11.121231,1,0,1,0,1,0,0,0,0,1,142,0.0,Trentino Alto Adige,1059114,124
1166,2020-03-02T18:00:00,ITA,8,46.068935,11.121231,1,0,1,0,1,0,0,0,0,1,142,0.0,Trentino Alto Adige,1059114,124
1167,2020-03-03T18:00:00,ITA,8,46.068935,11.121231,2,0,2,3,5,4,4,0,0,5,142,0.0,Trentino Alto Adige,1059114,124
1168,2020-03-04T17:00:00,ITA,8,46.068935,11.121231,2,0,2,4,6,1,1,0,0,6,142,0.0,Trentino Alto Adige,1059114,124
1169,2020-03-05T17:00:00,ITA,8,46.068935,11.121231,3,0,3,5,8,2,2,0,0,8,142,0.0,Trentino Alto Adige,1059114,124
1170,2020-03-06T17:00:00,ITA,8,46.068935,11.121231,8,0,8,6,14,6,6,0,0,14,158,0.0,Trentino Alto Adige,1059114,124
1171,2020-03-07T18:00:00,ITA,8,46.068935,11.121231,14,1,15,8,23,9,9,0,0,23,230,0.0,Trentino Alto Adige,1059114,124
1172,2020-03-08T18:00:00,ITA,8,46.068935,11.121231,15,2,17,15,32,9,9,0,0,32,264,0.0,Trentino Alto Adige,1059114,124
1173,2020-03-09T18:00:00,ITA,8,46.068935,11.121231,18,2,20,22,42,10,10,0,0,42,303,0.0,Trentino Alto Adige,1059114,124
1174,2020-03-10T18:00:00,ITA,8,46.068935,11.121231,36,4,40,48,88,46,48,2,0,90,435,0.0,Trentino Alto Adige,1059114,124
1175,2020-03-11T17:00:00,ITA,8,46.068935,11.121231,36,8,44,105,149,61,62,3,0,152,602,0.0,Trentino Alto Adige,1059114,124
1176,2020-03-12T17:00:00,ITA,8,46.068935,11.121231,64,9,73,132,205,56,59,4,2,211,1200,0.0,Trentino Alto Adige,1059114,124
1177,2020-03-13T17:00:00,ITA,8,46.068935,11.121231,78,11,89,191,280,75,77,4,4,288,1657,0.0,Trentino Alto Adige,1059114,124
1178,2020-03-14T17:00:00,ITA,8,46.068935,11.121231,94,19,113,256,369,89,91,5,5,379,2141,0.0,Trentino Alto Adige,1059114,124
1179,2020-03-15T17:00:00,ITA,8,46.068935,11.121231,123,23,146,420,566,197,203,5,11,582,2503,0.0,Trentino Alto Adige,1059114,124
1180,2020-03-16T17:00:00,ITA,8,46.068935,11.121231,126,30,156,446,602,36,37,5,12,619,2746,0.0,Trentino Alto Adige,1059114,124
1181,2020-03-17T17:00:00,ITA,8,46.068935,11.121231,178,33,211,439,650,48,57,11,15,676,3876,0.0,Trentino Alto Adige,1059114,124
1182,2020-03-18T17:00:00,ITA,8,46.068935,11.121231,220,40,260,542,802,152,155,13,16,831,5031,0.0,Trentino Alto Adige,1059114,124
1183,2020-03-19T17:00:00,ITA,8,46.068935,11.121231,256,48,304,608,912,110,128,21,26,959,5771,0.0,Trentino Alto Adige,1059114,124
1184,2020-03-20T17:00:00,ITA,8,46.068935,11.121231,297,58,355,775,1130,218,231,30,30,1190,7089,0.0,Trentino Alto Adige,1059114,124
1185,2020-03-21T17:00:00,ITA,8,46.068935,11.121231,360,69,429,891,1320,190,213,35,48,1403,7835,0.0,Trentino Alto Adige,1059114,124
1186,2020-03-22T17:00:00,ITA,8,46.068935,11.121231,381,78,459,1074,1533,213,229,41,58,1632,8768,0.0,Trentino Alto Adige,1059114,124
1187,2020-03-23T17:00:00,ITA,8,46.068935,11.121231,394,79,473,1129,1602,69,115,75,70,1747,9234,0.0,Trentino Alto Adige,1059114,124
1188,2020-03-24T17:00:00,ITA,8,46.068935,11.121231,474,87,561,1113,1674,72,144,123,94,1891,10221,0.0,Trentino Alto Adige,1059114,124
1189,2020-03-25T17:00:00,ITA,8,46.068935,11.121231,498,105,603,1203,1806,132,189,157,117,2080,10763,0.0,Trentino Alto Adige,1059114,124
1190,2020-03-26T17:00:00,ITA,8,46.068935,11.121231,523,109,632,1253,1885,79,123,184,134,2203,12344,0.0,Trentino Alto Adige,1059114,124
1191,2020-03-27T17:00:00,ITA,8,46.068935,11.121231,590,111,701,1296,1997,112,191,235,162,2394,13443,0.0,Trentino Alto Adige,1059114,124
1192,2020-03-28T17:00:00,ITA,8,46.068935,11.121231,576,123,699,1464,2163,166,220,267,184,2614,14729,0.0,Trentino Alto Adige,1059114,124
1193,2020-03-29T17:00:00,ITA,8,46.068935,11.121231,590,131,721,1606,2327,164,194,288,193,2808,16087,0.0,Trentino Alto Adige,1059114,124
1194,2020-03-30T17:00:00,ITA,8,46.068935,11.121231,584,140,724,1731,2455,128,199,331,221,3007,17017,0.0,Trentino Alto Adige,1059114,124
1195,2020-03-31T17:00:00,ITA,8,46.068935,11.121231,603,142,745,1786,2531,76,110,346,240,3117,18248,0.0,Trentino Alto Adige,1059114,124
1196,2020-04-01T17:00:00,ITA,8,46.068935,11.121231,614,133,747,1848,2595,64,171,404,289,3288,19626,0.0,Trentino Alto Adige,1059114,124
1197,2020-04-02T17:00:00,ITA,8,46.068935,11.121231,618,138,756,1991,2747,152,194,419,316,3482,21173,0.0,Trentino Alto Adige,1059114,124
1198,2020-04-03T17:00:00,ITA,8,46.068935,11.121231,634,140,774,2094,2868,121,186,457,343,3668,22969,0.0,Trentino Alto Adige,1059114,124
1199,2020-04-04T17:00:00,ITA,8,46.068935,11.121231,644,142,786,2168,2954,86,144,502,356,3812,24908,0.0,Trentino Alto Adige,1059114,124
1200,2020-04-05T17:00:00,ITA,8,46.068935,11.121231,591,133,724,2297,3021,67,117,533,375,3929,26199,0.0,Trentino Alto Adige,1059114,124
1201,2020-04-06T17:00:00,ITA,8,46.068935,11.121231,599,131,730,2368,3098,77,141,578,394,4070,27955,0.0,Trentino Alto Adige,1059114,124
1202,2020-04-07T17:00:00,ITA,8,46.068935,11.121231,685,142,827,2364,3191,93,217,678,418,4287,29791,0.0,Trentino Alto Adige,1059114,124
1203,2020-04-08T17:00:00,ITA,8,46.068935,11.121231,622,142,764,2457,3221,30,150,778,438,4437,32123,0.0,Trentino Alto Adige,1059114,124
1204,2020-04-09T17:00:00,ITA,8,46.068935,11.121231,608,133,741,2552,3293,72,174,863,455,4611,34213,0.0,Trentino Alto Adige,1059114,124
1205,2020-04-10T17:00:00,ITA,8,46.068935,11.121231,593,128,721,2590,3311,18,160,994,466,4771,35847,0.0,Trentino Alto Adige,1059114,124
1206,2020-04-11T17:00:00,ITA,8,46.068935,11.121231,581,118,699,2634,3333,22,156,1110,484,4927,38832,0.0,Trentino Alto Adige,1059114,124
1207,2020-04-12T17:00:00,ITA,8,46.068935,11.121231,505,106,611,2986,3597,264,224,1056,498,5151,41043,0.0,Trentino Alto Adige,1059114,124
1208,2020-04-13T17:00:00,ITA,8,46.068935,11.121231,516,97,613,3004,3617,20,124,1146,512,5275,42743,0.0,Trentino Alto Adige,1059114,124
1209,2020-04-14T17:00:00,ITA,8,46.068935,11.121231,502,93,595,3051,3646,29,50,1155,524,5325,43231,0.0,Trentino Alto Adige,1059114,124
1210,2020-04-15T17:00:00,ITA,8,46.068935,11.121231,478,80,558,3122,3680,34,119,1223,541,5444,44905,0.0,Trentino Alto Adige,1059114,124
1211,2020-04-16T17:00:00,ITA,8,46.068935,11.121231,476,77,553,3127,3680,0,117,1334,547,5561,47189,0.0,Trentino Alto Adige,1059114,124
1212,2020-04-17T17:00:00,ITA,8,46.068935,11.121231,467,76,543,3029,3572,-108,111,1524,576,5672,49619,0.0,Trentino Alto Adige,1059114,124
1213,2020-04-18T17:00:00,ITA,8,46.068935,11.121231,455,70,525,3016,3541,-31,84,1628,587,5756,52035,0.0,Trentino Alto Adige,1059114,124
1214,2020-04-19T17:00:00,ITA,8,46.068935,11.121231,440,64,504,3033,3537,-4,156,1770,605,5912,54749,31468.0,Trentino Alto Adige,1059114,124
1215,2020-04-20T17:00:00,ITA,8,46.068935,11.121231,432,59,491,2978,3469,-68,72,1900,615,5984,57592,32436.0,Trentino Alto Adige,1059114,124
1216,2020-04-21T17:00:00,ITA,8,46.068935,11.121231,413,58,471,2974,3445,-24,40,1952,627,6024,58597,33110.0,Trentino Alto Adige,1059114,124
1217,2020-04-22T17:00:00,ITA,8,46.068935,11.121231,402,53,455,2931,3386,-59,38,2039,637,6062,59396,33408.0,Trentino Alto Adige,1059114,124
1218,2020-04-23T17:00:00,ITA,8,46.068935,11.121231,375,46,421,2944,3365,-21,100,2154,643,6162,62234,35098.0,Trentino Alto Adige,1059114,124
1219,2020-04-24T17:00:00,ITA,8,46.068935,11.121231,372,44,416,2504,2920,-445,70,2660,652,6232,64841,36274.0,Trentino Alto Adige,1059114,124
